TGAATCAAAGTACCATGGA -> GAATCAAAGTACCATGGAA
CGCCTGGTAACATTACTAC -> GCCTGGTAACATTACTACA
GTGCGTACACCCGAGCTTG -> TGCGTACACCCGAGCTTGG
TTCATGCGAGATAGAGAAC -> TCATGCGAGATAGAGAACA
AGGTACGTCCCTAGTGGTC -> GGTACGTCCCTAGTGGTCG
AATGATAAGTTACAACCGC -> ATGATAAGTTACAACCGCC
TAAAAGTTGGCTTTAACGT -> AAAAGTTGGCTTTAACGTA
TAGGCGGTCTTGATGGCTC -> AGGCGGTCTTGATGGCTCG
CGCTAACTAGCTTAGAATG -> GCTAACTAGCTTAGAATGG
TAGTAACTTCTCCACGATC -> AGTAACTTCTCCACGATCC
TCCCCGCTGGTAGTAACCT -> CCCCGCTGGTAGTAACCTT
TGAAATGGGCGCAGCTGAG -> GAAATGGGCGCAGCTGAGA
CAGCCTAGTCGGGTGGAGT -> AGCCTAGTCGGGTGGAGTG
TTTAACGTAGCATGCAGGT -> TTAACGTAGCATGCAGGTG
ATGGCTCGGATTGCAACAC -> TGGCTCGGATTGCAACACA
GCCGATAATCGGAGATATA -> CCGATAATCGGAGATATAC
TCACAATGTTCGTAATACA -> CACAATGTTCGTAATACAG
TTATCACACAGAGAATCCG -> TATCACACAGAGAATCCGC
TATTATGAAGGCTCTTTCT -> ATTATGAAGGCTCTTTCTT
TAATTTCGTTCTTAGACTG -> AATTTCGTTCTTAGACTGG
AGAATCCGCTACCACTGGG -> GAATCCGCTACCACTGGGC
CAAAAGCCTATACGAGGCA -> AAAAGCCTATACGAGGCAT
TTGATGGCTCGGCCGGCGA -> TGATGGCTCGGCCGGCGAA
AACTTCAGAGGCTGTCCGC -> ACTTCAGAGGCTGTCCGCT
GGTACGTCCCTAGTGGTCG -> GTACGTCCCTAGTGGTCGG
TGGGTTCTCGGCTTGTCAC -> GGGTTCTCGGCTTGTCACA
CCCACCAATTAAAACATAG -> CCACCAATTAAAACATAGT
TTAGTCGCTCGGCGCGCTG -> TAGTCGCTCGGCGCGCTGT
CATGCAGGTGAAGGCGTAC -> ATGCAGGTGAAGGCGTACT
GTCACAGAACACAGATCGC -> TCACAGAACACAGATCGCG
TTTCCTTGACGCAGACCCA -> TTCCTTGACGCAGACCCAT
GGCCGCCGGTCACAGAACA -> GCCGCCGGTCACAGAACAC
TCGATCTTAGCAGGTCCGA -> CGATCTTAGCAGGTCCGAG
GGGGCACGAGGGAGCTAGC -> GGGCACGAGGGAGCTAGCC
TACGCCGGGCCCATCGAAA -> ACGCCGGGCCCATCGAAAT
AATTATTGTCATGCAATGG -> ATTATTGTCATGCAATGGA
AATACAGATCGTGCAGAGT -> ATACAGATCGTGCAGAGTC
TTATTGTCATGCAATGGAG -> TATTGTCATGCAATGGAGG
AGAATACAGATCGTGCAGA -> GAATACAGATCGTGCAGAG
AAATTATTGTCATGCAATG -> AATTATTGTCATGCAATGG
GCGCTTAAAAATCTTGTGT -> CGCTTAAAAATCTTGTGTC
AACTGCGGTGGGTTTGATT -> ACTGCGGTGGGTTTGATTT
TTGGGAATCTCATGATTAA -> TGGGAATCTCATGATTAAT
GTATTATATTGACAAAACT -> TATTATATTGACAAAACTC
CGTGTTCATATCTGGCAGA -> GTGTTCATATCTGGCAGAG
ACTTAACGTTCCCGTGGTG -> CTTAACGTTCCCGTGGTGA
TTATACCCTTGTCTCCGCC -> TATACCCTTGTCTCCGCCT
GACAAAACTCCTAATGTTA -> ACAAAACTCCTAATGTTAA
CCTCACGCAGGTACAAGAT -> CTCACGCAGGTACAAGATT
CGATCTTAGCAGGTCCGAG -> GATCTTAGCAGGTCCGAGC
TCCGGATACCGTGTTCATA -> CCGGATACCGTGTTCATAT
CAGGTAGTCTAGAATGATA -> AGGTAGTCTAGAATGATAA
GTTTCGCGAAGGACCCATC -> TTTCGCGAAGGACCCATCG
TGGCTTTAACGTAGCATGC -> GGCTTTAACGTAGCATGCA
CCCTAGTGGTCGGGGCACG -> CCTAGTGGTCGGGGCACGA
GGCGGTCTTGATGGCTCGT -> GCGGTCTTGATGGCTCGTG
ACTCGCCATTGAAGTCTGG -> CTCGCCATTGAAGTCTGGT
AAACCGGTTAGATGCCCAC -> AACCGGTTAGATGCCCACC
AGGTACAAGATTCATTTTG -> GGTACAAGATTCATTTTGC
GGAACTTCAGAGGCTGTCC -> GAACTTCAGAGGCTGTCCG
GTATGCGGAGTATATTATG -> TATGCGGAGTATATTATGA
CTGATGATTTCATGCGAGA -> TGATGATTTCATGCGAGAT
GTCGTTGGAGTTATTGGGC -> TCGTTGGAGTTATTGGGCT
ATGTTAAGGAGCGAATCGC -> TGTTAAGGAGCGAATCGCG
AATCTCTATCGTGGTCCCT -> ATCTCTATCGTGGTCCCTC
GGCCCATCGAAATGGGGAG -> GCCCATCGAAATGGGGAGG
ATGAATCAAAGTACCATGG -> TGAATCAAAGTACCATGGA
CTTGATGGCTCGTGCGGTC -> TTGATGGCTCGTGCGGTCT
ATTGAGACATCAGCGCTTA -> TTGAGACATCAGCGCTTAA
CTTGACGCAGACCCATCGG -> TTGACGCAGACCCATCGGT
AATGATAGCAGCCTAGTCG -> ATGATAGCAGCCTAGTCGG
CGCTTAAAAATCTTGTGTC -> GCTTAAAAATCTTGTGTCC
CTGGCAGAGTGTTGTAATA -> TGGCAGAGTGTTGTAATAC
GCAGCCTAGTCGGGTGGAG -> CAGCCTAGTCGGGTGGAGT
AGATCGTGCAGAGTCGGAA -> GATCGTGCAGAGTCGGAAA
TTAGTTTTGGCGGTGCTCC -> TAGTTTTGGCGGTGCTCCC
GGGCCGTAAAATGGTACTC -> GGCCGTAAAATGGTACTCG
CTGAGACTTTACCGTGTAG -> TGAGACTTTACCGTGTAGG
TGGATGGCGGCCGCCGGTC -> GGATGGCGGCCGCCGGTCA
TTAAAAATCTTGTGTCCGA -> TAAAAATCTTGTGTCCGAC
TCGGGTGGAGTGTATTTTC -> CGGGTGGAGTGTATTTTCC
ACCCATCGGTATCTGATTA -> CCCATCGGTATCTGATTAT
GTCCGAGCCACTGGTGTAT -> TCCGAGCCACTGGTGTATT
CCATCCCCGCTGGTAGTAA -> CATCCCCGCTGGTAGTAAC
ACCACTGGGCACGAGTCAG -> CCACTGGGCACGAGTCAGA
AATCTTTAGTTTCGCGAAG -> ATCTTTAGTTTCGCGAAGG
TCGGAGAAGCGGTCTTGAT -> CGGAGAAGCGGTCTTGATG
GCTGAGACTTTACCGTGTA -> CTGAGACTTTACCGTGTAG
CTGTATTCCATCTGGTCCA -> TGTATTCCATCTGGTCCAT
ACCTTAGTCGCTCGGCGCG -> CCTTAGTCGCTCGGCGCGC
CCATCGGTCTAAAAGAGAC -> CATCGGTCTAAAAGAGACT
GAGAAGCAGTATGCGGAGT -> AGAAGCAGTATGCGGAGTA
CTGGTAACATTACTACACA -> TGGTAACATTACTACACAC
GCCGGTAAGGCCGTTCACC -> CCGGTAAGGCCGTTCACCC
TATTAGTTTTGGCGGTGCT -> ATTAGTTTTGGCGGTGCTC
ATTCAAGCTCCCCTCCATG -> TTCAAGCTCCCCTCCATGA
ACACCCGAGCTTGGTTACA -> CACCCGAGCTTGGTTACAA
ATATCCAATGATAGCAGCC -> TATCCAATGATAGCAGCCT
GGCCCCATCCCCGCTGGTA -> GCCCCATCCCCGCTGGTAG
CTCGGATTGCAACACACAG -> TCGGATTGCAACACACAGA
TAAAACATAGTCTTTTGAC -> AAAACATAGTCTTTTGACG
TTCGCGTAGAAGCGCATCA -> TCGCGTAGAAGCGCATCAA
GCCTAGTCGGGTGGAGTGT -> CCTAGTCGGGTGGAGTGTA
GGATTGCAACACACAGACC -> GATTGCAACACACAGACCC
ACTGGGCACGAGTCAGAAT -> CTGGGCACGAGTCAGAATC
TCGCGTAGAAGCGCATCAA -> CGCGTAGAAGCGCATCAAT
TTTGGCCTGCATAGAGCTG -> TTGGCCTGCATAGAGCTGG
AAAAATCTTGTGTCCGACT -> AAAATCTTGTGTCCGACTC
CGGTCTTGATGGCTCGGCC -> GGTCTTGATGGCTCGGCCG
GTGCTCGAGATCGTTTCTA -> TGCTCGAGATCGTTTCTAA
GCGTACCTGTGAAATCTCT -> CGTACCTGTGAAATCTCTA
TAACTAGCTTAGAATGGCA -> AACTAGCTTAGAATGGCAC
GCCTTAATAGCTGTACATA -> CCTTAATAGCTGTACATAC
ATTATGGATGGCGGCCGCC -> TTATGGATGGCGGCCGCCG
TAAAAGAGACTGTTGAACG -> AAAAGAGACTGTTGAACGT
TGGTGATTGAACTGCGGTG -> GGTGATTGAACTGCGGTGG
GAAGGTTAAAGTTTCCCGA -> AAGGTTAAAGTTTCCCGAT
CCGATAAATCTTTAGTTTC -> CGATAAATCTTTAGTTTCG
TGCTCGAGATCGTTTCTAA -> GCTCGAGATCGTTTCTAAA
TGAGACATCAGCGCTTAAA -> GAGACATCAGCGCTTAAAA
CGGTCTTGATGGCTCGTGC -> GGTCTTGATGGCTCGTGCG
GGCATCAGCAGAAGGCACG -> GCATCAGCAGAAGGCACGT
GTTCACCCACCGTTTCTAA -> TTCACCCACCGTTTCTAAC
TAGGAGCCCATCCAGAAGT -> AGGAGCCCATCCAGAAGTC
GCATAGAGCTGGTATTATG -> CATAGAGCTGGTATTATGG
TCAAAATATTAGTTTTGGC -> CAAAATATTAGTTTTGGCG
ACTGGTGATTGAACTGCGG -> CTGGTGATTGAACTGCGGT
TGCGGTCTTGATGGCTCGG -> GCGGTCTTGATGGCTCGGT
ACCCATCGGTCTAAAAATA -> CCCATCGGTCTAAAAATAC
TTGGCTTTAACGTAGCATG -> TGGCTTTAACGTAGCATGC
CTCCATGAGACTTGGCGGC -> TCCATGAGACTTGGCGGCG
GTAACATTACTACACACAG -> TAACATTACTACACACAGG
GATACCGTGTTCATATCTG -> ATACCGTGTTCATATCTGG
GGGGTGACCTGAGAATACA -> GGGTGACCTGAGAATACAG
AGACCCATCGGTCTAAAAG -> GACCCATCGGTCTAAAAGA,GACCCATCGGTCTAAAAGG,GACCCATCGGTCTAAAAGT
TAATACCAGGCCCGCAGAT -> AATACCAGGCCCGCAGATA
TTCCGTGTGACACCATGCG -> TCCGTGTGACACCATGCGG
TACCAGGCCCGCAGATACG -> ACCAGGCCCGCAGATACGA
ATCTTTATCATGACCCTCG -> TCTTTATCATGACCCTCGG
GTGTGCGCATTGGACGCGT -> TGTGCGCATTGGACGCGTT
TGTATTATATTGACAAAAC -> GTATTATATTGACAAAACT
GGCGAATGTCAGACCCATC -> GCGAATGTCAGACCCATCG
TCGTTCTTAGACTGGTGAT -> CGTTCTTAGACTGGTGATT
GCAGTATGCGGAGTATATT -> CAGTATGCGGAGTATATTA
GAGTTATTGGGCTGGGTTC -> AGTTATTGGGCTGGGTTCT
TCTCTTAGTTACCTCCGTG -> CTCTTAGTTACCTCCGTGC
ATAGCAGCCTAGTCGGGTG -> TAGCAGCCTAGTCGGGTGG
TGGGGAGGACAGAAGACCT -> GGGGAGGACAGAAGACCTC
TCGGTCTAAAAGGCCGACC -> CGGTCTAAAAGGCCGACCA
CCTAGTCCGTGGGGTGACC -> CTAGTCCGTGGGGTGACCT
CATATCTGGCAGAGTGTTG -> ATATCTGGCAGAGTGTTGT
TTACGAGGTACGGCCGCCG -> TACGAGGTACGGCCGCCGT
AACATGAATCAAAGTACCA -> ACATGAATCAAAGTACCAT
TCGGGGCACGAGGGAGCTA -> CGGGGCACGAGGGAGCTAG
ACAACCGCCGTCGTTGGAG -> CAACCGCCGTCGTTGGAGT
GAGGCTGTCCGCTTGACCC -> AGGCTGTCCGCTTGACCCT
AAAATATTAGTTTTGGCGG -> AAATATTAGTTTTGGCGGT
CCGCAGATACGATTAGTAG -> CGCAGATACGATTAGTAGT
TACTACACACAGGTAGTCT -> ACTACACACAGGTAGTCTA
GCGCCGGTAAGGCCGTTCA -> CGCCGGTAAGGCCGTTCAC
TGCATAGAGCTGGTATTAT -> GCATAGAGCTGGTATTATG
GATCTCTTAGTTACCTCCG -> ATCTCTTAGTTACCTCCGT
CATTCAAGCTCCCCTCCAT -> ATTCAAGCTCCCCTCCATG
TTGTCTCCGCCTTTGGCCT -> TGTCTCCGCCTTTGGCCTG
CCCTTGTCTCCGCCTTTGG -> CCTTGTCTCCGCCTTTGGC
GGTAGTCTAGAATGATAAG -> GTAGTCTAGAATGATAAGT
AGCTAGCCACTAGTCCTGA -> GCTAGCCACTAGTCCTGAA
CCTAGTGGTCGGGGCACGA -> CTAGTGGTCGGGGCACGAG
GGGGAGGACAGAAGACCTC -> GGGAGGACAGAAGACCTCT
AGCCTATACGAGGCATCAG -> GCCTATACGAGGCATCAGC
GGTGATTGAACTGCGGTGG -> GTGATTGAACTGCGGTGGG
AGACCCATCGGTCTAAAAA -> GACCCATCGGTCTAAAAAT
CTTGGTTACAAATTGAGAC -> TTGGTTACAAATTGAGACA
CGTTCTTAGACTGGTGATT -> GTTCTTAGACTGGTGATTG
CGATAATCGGAGATATACA -> GATAATCGGAGATATACAT
GCTGTCCGCTTGACCCTCA -> CTGTCCGCTTGACCCTCAC
TGGCTCGGTTTCCTTGACG -> GGCTCGGTTTCCTTGACGC
TAGTCGGGTGGAGTGTATT -> AGTCGGGTGGAGTGTATTT
AGAACACAGATCGCGTTCC -> GAACACAGATCGCGTTCCA
GGATGGCGGCCGCCGGTCA -> GATGGCGGCCGCCGGTCAC
ATCCGCTACCACTGGGCAC -> TCCGCTACCACTGGGCACG
TGATGGCTCGGATTGCAAC -> GATGGCTCGGATTGCAACA
CGAGATAGAGAACAGCTCT -> GAGATAGAGAACAGCTCTG
AGTGTATTTTCCGTGTGAC -> GTGTATTTTCCGTGTGACA
TGAGTCTAGCGTACCTGTG -> GAGTCTAGCGTACCTGTGA
CCTGTGAAATCTCTATCGT -> CTGTGAAATCTCTATCGTG
GATAGCAGCCTAGTCGGGT -> ATAGCAGCCTAGTCGGGTG
TATGGATGGCGGCCGCCGG -> ATGGATGGCGGCCGCCGGT
GTCAGAATCCTCTGTCATC -> TCAGAATCCTCTGTCATCG
GAAATCTCTATCGTGGTCC -> AAATCTCTATCGTGGTCCC
GAAGGACCCATCGGTATCT -> AAGGACCCATCGGTATCTG
CTTCTCCACGATCCGGATA -> TTCTCCACGATCCGGATAC
TCGGAGATATACATCCCTC -> CGGAGATATACATCCCTCG
GTGATTGAACTGCGGTGGG -> TGATTGAACTGCGGTGGGT
TTTCTAAAGACATATCCAA -> TTCTAAAGACATATCCAAT
CGTTTCTAACAAAAGCCTA -> GTTTCTAACAAAAGCCTAT
TTAAAAAACTAAATATCGG -> TAAAAAACTAAATATCGGA
CACAGATCGCGTTCCATAA -> ACAGATCGCGTTCCATAAA
TCGCCACCCTTTGACCCTA -> CGCCACCCTTTGACCCTAG
AAATGGGGAGGACAGAAGA -> AATGGGGAGGACAGAAGAC
CGTGCGTACACCCGAGCTT -> GTGCGTACACCCGAGCTTG
TTGGCGGCGATGGTCAAAT -> TGGCGGCGATGGTCAAATT
ATAAATCTTTAGTTTCGCG -> TAAATCTTTAGTTTCGCGA
CGAGGCATCAGCAGAAGGC -> GAGGCATCAGCAGAAGGCA
CCGGTCACAGAACACAGAT -> CGGTCACAGAACACAGATC
ATGGCTCGTGCGGTCTTGA -> TGGCTCGTGCGGTCTTGAT
GTATTCCATCTGGTCCATT -> TATTCCATCTGGTCCATTC
TACGAGGTACGGCCGCCGT -> ACGAGGTACGGCCGCCGTC
CGCATTGGACGCGTTGAGT -> GCATTGGACGCGTTGAGTC
CCGCTACCACTGGGCACGA -> CGCTACCACTGGGCACGAG
TTAATTTCGTTCTTAGACT -> TAATTTCGTTCTTAGACTG
TACCTCTGTTATTTTATAC -> ACCTCTGTTATTTTATACC
ATGACCCTCGGTTGCGCCT -> TGACCCTCGGTTGCGCCTT
ACATATCCAATGATAGCAG -> CATATCCAATGATAGCAGC
CGGGCCGTAAAATGGTACT -> GGGCCGTAAAATGGTACTC
GACCTGAGAATACAGATCG -> ACCTGAGAATACAGATCGT
ACTCGCTCACCGCCAGCGA -> CTCGCTCACCGCCAGCGAG
TTAATAGCTGTACATACAC -> TAATAGCTGTACATACACA
TTTCGCGAAGGACCCATCG -> TTCGCGAAGGACCCATCGG
CCGCCGGTCACAGAACACA -> CGCCGGTCACAGAACACAG
GGCTGTCCGCTTGACCCTC -> GCTGTCCGCTTGACCCTCA
CGGGCCCATCGAAATGGGG -> GGGCCCATCGAAATGGGGA
AACAGCTCTGCGATACATT -> ACAGCTCTGCGATACATTC
TCGCCATTGAAGTCTGGTG -> CGCCATTGAAGTCTGGTGA
TTGTTAAAGTAACTCAAAA -> TGTTAAAGTAACTCAAAAT
AGGACAGAAGACCTCTTTC -> GGACAGAAGACCTCTTTCG
CAGCGCCGGTAAGGCCGTT -> AGCGCCGGTAAGGCCGTTC
CTCGGCCGGCGAATGTCAG -> TCGGCCGGCGAATGTCAGA
CGTAGCATGCAGGTGAAGG -> GTAGCATGCAGGTGAAGGC
TTGCAACACACAGACCCAT -> TGCAACACACAGACCCATC
GAGAAGCGGTCTTGATGGC -> AGAAGCGGTCTTGATGGCT
TGGCACTGTATTCCATCTG -> GGCACTGTATTCCATCTGG
ACACAGACCCATCGGTCTA -> CACAGACCCATCGGTCTAA
GCCGTTCACCCACCGTTTC -> CCGTTCACCCACCGTTTCT
TATATTATGAAGGCTCTTT -> ATATTATGAAGGCTCTTTC
AGGATGTTTTAAGTCAGTA -> GGATGTTTTAAGTCAGTAG
GTTAGATGCCCACCAATTA -> TTAGATGCCCACCAATTAA
TTTATACCCTTGTCTCCGC -> TTATACCCTTGTCTCCGCC
AGCAGCCTAGTCGGGTGGA -> GCAGCCTAGTCGGGTGGAG
GCAGCGCCGGTAAGGCCGT -> CAGCGCCGGTAAGGCCGTT
ACGTCCCTAGTGGTCGGGG -> CGTCCCTAGTGGTCGGGGC
TATCTGGCAGAGTGTTGTA -> ATCTGGCAGAGTGTTGTAA
TGCGATACATTCCAAGATC -> GCGATACATTCCAAGATCT
CTGGGAGCAACGATTGCCG -> TGGGAGCAACGATTGCCGT
GTAACTTCTCCACGATCCG -> TAACTTCTCCACGATCCGG
CTATACGAGGCATCAGCAG -> TATACGAGGCATCAGCAGA
CGGTATCTGATTATACCCC -> GGTATCTGATTATACCCCA
GAATGGCTGTAGCGTGGTT -> AATGGCTGTAGCGTGGTTA
GTCCGACTCAAGGAGAAGG -> TCCGACTCAAGGAGAAGGC
ACGCCGGGCCCATCGAAAT -> CGCCGGGCCCATCGAAATG
AGTCGCCACCCTTTGACCC -> GTCGCCACCCTTTGACCCT
AAAGCCGATAATCGGAGAT -> AAGCCGATAATCGGAGATA
AGCTTGGTTACAAATTGAG -> GCTTGGTTACAAATTGAGA
CCATGCGGGCCGTAAAATG -> CATGCGGGCCGTAAAATGG
CACCCAAAGCCTTGATACC -> ACCCAAAGCCTTGATACCG
CAACGATTGCCGTAGTAAC -> AACGATTGCCGTAGTAACT
TAGAATGATAAGTTACAAC -> AGAATGATAAGTTACAACC
AGATTCATTTTGCCGTGCT -> GATTCATTTTGCCGTGCTA
TGATTAATTTCGTTCTTAG -> GATTAATTTCGTTCTTAGA
TAGAATGGCACTGTATTCC -> AGAATGGCACTGTATTCCA
CCCTCGGTTGCGCCTTAAT -> CCTCGGTTGCGCCTTAATA
GCGATACATTCCAAGATCT -> CGATACATTCCAAGATCTC
CGCCATTGAAGTCTGGTGA -> GCCATTGAAGTCTGGTGAA
CCGCTGGTAGTAACCTTAG -> CGCTGGTAGTAACCTTAGT
CTTGGCGGCGATGGTCAAA -> TTGGCGGCGATGGTCAAAT
CGCGTTCCATAAACCGGTT -> GCGTTCCATAAACCGGTTA
CGCTCACCGCCAGCGAGAA -> GCTCACCGCCAGCGAGAAG
CGCAAAGCCGATAATCGGA -> GCAAAGCCGATAATCGGAG
TTTGATTTCAAACATGAAT -> TTGATTTCAAACATGAATC
GTCCATTCAAGCTCCCCTC -> TCCATTCAAGCTCCCCTCC
AGCCACTAGTCCTGAAGAA -> GCCACTAGTCCTGAAGAAG
TTCACCCACCGTTTCTAAC -> TCACCCACCGTTTCTAACA
ACTGTATTCCATCTGGTCC -> CTGTATTCCATCTGGTCCA
TTTGACGGCGCAAAGCCGA -> TTGACGGCGCAAAGCCGAT
GGCCTGCATAGAGCTGGTA -> GCCTGCATAGAGCTGGTAT
CTTAGTTACCTCCGTGCGT -> TTAGTTACCTCCGTGCGTA
ATGCTAGAATGGTAAGAGT -> TGCTAGAATGGTAAGAGTT
TGCTCCCGGTACGCCCCCA -> GCTCCCGGTACGCCCCCAT
TCTTTAGTTTCGCGAAGGA -> CTTTAGTTTCGCGAAGGAC
AGCAGAAGGCACGTGCCTG -> GCAGAAGGCACGTGCCTGA
TCGCGGTCTTGATGGCTCG -> CGCGGTCTTGATGGCTCGG
CTGTCCGCTTGACCCTCAC -> TGTCCGCTTGACCCTCACG
GGAGATATACATCCCTCGT -> GAGATATACATCCCTCGTT
CCCTCCATGAGACTTGGCG -> CCTCCATGAGACTTGGCGG
CGTCCCTAGTGGTCGGGGC -> GTCCCTAGTGGTCGGGGCA
TAAGTTACAACCGCCGTCG -> AAGTTACAACCGCCGTCGT
ACTGGGAGCAACGATTGCC -> CTGGGAGCAACGATTGCCG
TATTTTCCGTGTGACACCA -> ATTTTCCGTGTGACACCAT
GCAAAGCCGATAATCGGAG -> CAAAGCCGATAATCGGAGA
CCACCGTTTCTAACAAAAG -> CACCGTTTCTAACAAAAGC
CCGTTCACCCACCGTTTCT -> CGTTCACCCACCGTTTCTA
CGCGGTCTTGATGGCTCGG -> GCGGTCTTGATGGCTCGGC
GCCCGCAGATACGATTAGT -> CCCGCAGATACGATTAGTA
TACGCCCCCATCGCGGTCT -> ACGCCCCCATCGCGGTCTT
TAACATTACTACACACAGG -> AACATTACTACACACAGGT
ACACACAGGTAGTCTAGAA -> CACACAGGTAGTCTAGAAT
TGATACCGAAGGTTAAAGT -> GATACCGAAGGTTAAAGTT
ATGGTACTCGCTCACCGCC -> TGGTACTCGCTCACCGCCA
GGCTGTAGCGTGGTTACGA -> GCTGTAGCGTGGTTACGAG
GAGTCTAGCGTACCTGTGA -> AGTCTAGCGTACCTGTGAA
CCGTGTTCATATCTGGCAG -> CGTGTTCATATCTGGCAGA
TCGCTCACCGCCAGCGAGA -> CGCTCACCGCCAGCGAGAA
ATAAGTTACAACCGCCGTC -> TAAGTTACAACCGCCGTCG
ATGAATCCGGGCCGCCTGG -> TGAATCCGGGCCGCCTGGT
AGATCGTTTCTAAAGACAT -> GATCGTTTCTAAAGACATA
AATGGGGAGGACAGAAGAC -> ATGGGGAGGACAGAAGACC
TCGAAATGGGGAGGACAGA -> CGAAATGGGGAGGACAGAA
CCCCACTGGGAGCAACGAT -> CCCACTGGGAGCAACGATT
TCCAAGATCTCTTAGTTAC -> CCAAGATCTCTTAGTTACC
AGAAGGCAACTCCGTCGAA -> GAAGGCAACTCCGTCGAAG
CAGATCGCGTTCCATAAAC -> AGATCGCGTTCCATAAACC
GTTTGATTTCAAACATGAA -> TTTGATTTCAAACATGAAT
ATCGTGGTCCCTCGCTAAC -> TCGTGGTCCCTCGCTAACT
GTGGTGACTCCGCGGCCCC -> TGGTGACTCCGCGGCCCCA
GCAGAGTGTTGTAATACCA -> CAGAGTGTTGTAATACCAG
GGTGGGTTTGATTTCAAAC -> GTGGGTTTGATTTCAAACA
TGGTCAAATTATTGTCATG -> GGTCAAATTATTGTCATGC
GTGGGGTGACCTGAGAATA -> TGGGGTGACCTGAGAATAC
GATGATTTCATGCGAGATA -> ATGATTTCATGCGAGATAG
TGCGAGATAGAGAACAGCT -> GCGAGATAGAGAACAGCTC
TAAATCTTTAGTTTCGCGA -> AAATCTTTAGTTTCGCGAA
TGCGCCTTAATAGCTGTAC -> GCGCCTTAATAGCTGTACA
GGTACAAGATTCATTTTGC -> GTACAAGATTCATTTTGCC
TGTCCGACTCAAGGAGAAG -> GTCCGACTCAAGGAGAAGG
CGTGGTCCCTCGCTAACTA -> GTGGTCCCTCGCTAACTAG
CATCAATCGTCCACCGAGA -> ATCAATCGTCCACCGAGAA
AAGCTACATCTTTATCATG -> AGCTACATCTTTATCATGA
GCCTTGATACCGAAGGTTA -> CCTTGATACCGAAGGTTAA
TCTTGATGGCTCGGATTGC -> CTTGATGGCTCGGATTGCA
CCGACCATGTCAGACCCAT -> CGACCATGTCAGACCCATC
AGAGTTAGGACTGAAATGG -> GAGTTAGGACTGAAATGGG
GTTGAACGTACAGCCACCC -> TTGAACGTACAGCCACCCA
GCGAATGTCAGACCCATCG -> CGAATGTCAGACCCATCGG
GTGTAGGAGCCCATCCAGA -> TGTAGGAGCCCATCCAGAA
GTGTATTATATTGACAAAA -> TGTATTATATTGACAAAAC
GTTCCCGTGGTGACTCCGC -> TTCCCGTGGTGACTCCGCG
TTAACGTTCCCGTGGTGAC -> TAACGTTCCCGTGGTGACT
CTCTGTCATCGATCTTAGC -> TCTGTCATCGATCTTAGCA
GTTGGGAATCTCATGATTA -> TTGGGAATCTCATGATTAA
CGCCTTAATAGCTGTACAT -> GCCTTAATAGCTGTACATA
CGAGAGGAGGGGCGATCTA -> GAGAGGAGGGGCGATCTAT
GAATGGTAAGAGTTAGGAC -> AATGGTAAGAGTTAGGACT
ATTCCATCTGGTCCATTCA -> TTCCATCTGGTCCATTCAA
TTCTTAGACTGGTGATTGA -> TCTTAGACTGGTGATTGAA
TGTTGAACGTACAGCCACC -> GTTGAACGTACAGCCACCC
CACCGTTTCTAACAAAAGC -> ACCGTTTCTAACAAAAGCC
GCAACTCCGTCGAAGTAGT -> CAACTCCGTCGAAGTAGTG
GTGCCTGATGATTTCATGC -> TGCCTGATGATTTCATGCG
CCCATCGAAATGGGGAGGA -> CCATCGAAATGGGGAGGAC
TAGATGCCCACCAATTAAA -> AGATGCCCACCAATTAAAA
CCATGAGACTTGGCGGCGA -> CATGAGACTTGGCGGCGAT
GTACGTCCCTAGTGGTCGG -> TACGTCCCTAGTGGTCGGG
GGCCGCCTGGTAACATTAC -> GCCGCCTGGTAACATTACT
GTCTTGATGGCTCGGTTTC -> TCTTGATGGCTCGGTTTCC
GCTAAGCTACATCTTTATC -> CTAAGCTACATCTTTATCA
CGCCGGTCACAGAACACAG -> GCCGGTCACAGAACACAGA
CATGCGGGCCGTAAAATGG -> ATGCGGGCCGTAAAATGGT
ATGCGGGCCGTAAAATGGT -> TGCGGGCCGTAAAATGGTA
GAAGGCAACTCCGTCGAAG -> AAGGCAACTCCGTCGAAGT
GGTCCATTCAAGCTCCCCT -> GTCCATTCAAGCTCCCCTC
GATCGCGTTCCATAAACCG -> ATCGCGTTCCATAAACCGG
TTAAAGTTTCCCGATAAAT -> TAAAGTTTCCCGATAAATC
CCCCATCCCCGCTGGTAGT -> CCCATCCCCGCTGGTAGTA
ACGCCCCCATCGCGGTCTT -> CGCCCCCATCGCGGTCTTG
GTGTTGTAATACCAGGCCC -> TGTTGTAATACCAGGCCCG
GCGCTTATCACACAGAGAA -> CGCTTATCACACAGAGAAT
ATGGCTGTAGCGTGGTTAC -> TGGCTGTAGCGTGGTTACG
CACAGACCCATCGGTCTAA -> ACAGACCCATCGGTCTAAA
GGTCTAAAAGGCCGACCAT -> GTCTAAAAGGCCGACCATG
TCTTGATGGCTCGGCCGGC -> CTTGATGGCTCGGCCGGCG
GCGATCTATAGTGTGCGCA -> CGATCTATAGTGTGCGCAT
ACCATGTCAGACCCATCGG -> CCATGTCAGACCCATCGGT
GGCAGAGTGTTGTAATACC -> GCAGAGTGTTGTAATACCA
CAGACCCATCGGTCTAAAA -> AGACCCATCGGTCTAAAAG,AGACCCATCGGTCTAAAAG,AGACCCATCGGTCTAAAAA,AGACCCATCGGTCTAAAAG
TTGGCCTGCATAGAGCTGG -> TGGCCTGCATAGAGCTGGT
TGATTGAACTGCGGTGGGT -> GATTGAACTGCGGTGGGTT
GGCTCGGTTTCCTTGACGC -> GCTCGGTTTCCTTGACGCA
TTCTCCACGATCCGGATAC -> TCTCCACGATCCGGATACC
CAAAGTACCATGGAACGTA -> AAAGTACCATGGAACGTAG
CAAATTATTGTCATGCAAT -> AAATTATTGTCATGCAATG
CTTGATGGCTCGGATTGCA -> TTGATGGCTCGGATTGCAA
GCCAGGTGTTACTCGCCAT -> CCAGGTGTTACTCGCCATT
ATCCAATGATAGCAGCCTA -> TCCAATGATAGCAGCCTAG
AATATTAGTTTTGGCGGTG -> ATATTAGTTTTGGCGGTGC
ACGCGTTGAGTCTAGCGTA -> CGCGTTGAGTCTAGCGTAC
AACATAGTCTTTTGACGGC -> ACATAGTCTTTTGACGGCG
TCTAAAAGGCCGACCATGT -> CTAAAAGGCCGACCATGTC
TGTTTTAAGTCAGTAGCGC -> GTTTTAAGTCAGTAGCGCT
AGGCGGTCTTGATGGCTCG -> GGCGGTCTTGATGGCTCGT
GGCTTGTCACAATGTTCGT -> GCTTGTCACAATGTTCGTA
GGGTGACCTGAGAATACAG -> GGTGACCTGAGAATACAGA
TGTCTCCGCCTTTGGCCTG -> GTCTCCGCCTTTGGCCTGC
GGAGTGTATTTTCCGTGTG -> GAGTGTATTTTCCGTGTGA
TGGTAAGAGTTAGGACTGA -> GGTAAGAGTTAGGACTGAA
TGTGCTCGAGATCGTTTCT -> GTGCTCGAGATCGTTTCTA
CATTACTACACACAGGTAG -> ATTACTACACACAGGTAGT
AGCAGTATGCGGAGTATAT -> GCAGTATGCGGAGTATATT
CTGAGAATACAGATCGTGC -> TGAGAATACAGATCGTGCA
TGCCTGATGATTTCATGCG -> GCCTGATGATTTCATGCGA
AGAAGCGCATCAATCGTCC -> GAAGCGCATCAATCGTCCA
TCAGACCCATCGGTCTAAA -> CAGACCCATCGGTCTAAAA,CAGACCCATCGGTCTAAAA
GCTCGGCCGGCGAATGTCA -> CTCGGCCGGCGAATGTCAG
CCCAAAGCCTTGATACCGA -> CCAAAGCCTTGATACCGAA
TATACGAGGCATCAGCAGA -> ATACGAGGCATCAGCAGAA
TAAAGTTTCCCGATAAATC -> AAAGTTTCCCGATAAATCT
AACCGGTTAGATGCCCACC -> ACCGGTTAGATGCCCACCA
GCTACATCTTTATCATGAC -> CTACATCTTTATCATGACC
ACCAATTAAAACATAGTCT -> CCAATTAAAACATAGTCTT
GCCCCCATCGCGGTCTTGA -> CCCCCATCGCGGTCTTGAT
TCGAAGTAGTGCCAGGTGT -> CGAAGTAGTGCCAGGTGTT
AATAGCTGTACATACACAT -> ATAGCTGTACATACACATT
TAAAGACATATCCAATGAT -> AAAGACATATCCAATGATA
ACTTTACCGTGTAGGAGCC -> CTTTACCGTGTAGGAGCCC
TAGCGTGGTTACGAGGTAC -> AGCGTGGTTACGAGGTACG
GAATCAAAGTACCATGGAA -> AATCAAAGTACCATGGAAC
CTACATCTTTATCATGACC -> TACATCTTTATCATGACCC
ATAGTCTTTTGACGGCGCA -> TAGTCTTTTGACGGCGCAA
TGAACGTACAGCCACCCAA -> GAACGTACAGCCACCCAAA
CTGTGAAATCTCTATCGTG -> TGTGAAATCTCTATCGTGG
GTCCCTCGCTAACTAGCTT -> TCCCTCGCTAACTAGCTTA
CATGAGGATGTTTTAAGTC -> ATGAGGATGTTTTAAGTCA
TCTGGTGAATGGCTGTAGC -> CTGGTGAATGGCTGTAGCG
TACATCTTTATCATGACCC -> ACATCTTTATCATGACCCT
TCTAGGTACGTCCCTAGTG -> CTAGGTACGTCCCTAGTGG
CACGCAGGTACAAGATTCA -> ACGCAGGTACAAGATTCAT
AAATTGAGACATCAGCGCT -> AATTGAGACATCAGCGCTT
GAAGCGCATCAATCGTCCA -> AAGCGCATCAATCGTCCAC
ATCCTCTGTCATCGATCTT -> TCCTCTGTCATCGATCTTA
TTGACCCTCACGCAGGTAC -> TGACCCTCACGCAGGTACA
CAGTAGCGCTTATCACACA -> AGTAGCGCTTATCACACAG
CAGAGTCGGAAAGTTGTTA -> AGAGTCGGAAAGTTGTTAA
CCGTGGTGACTCCGCGGCC -> CGTGGTGACTCCGCGGCCC
CTGGTGTATTATATTGACA -> TGGTGTATTATATTGACAA
AACCTTAGTCGCTCGGCGC -> ACCTTAGTCGCTCGGCGCG
TCTGGTCCATTCAAGCTCC -> CTGGTCCATTCAAGCTCCC
TCGGTTTCCTTGACGCAGA -> CGGTTTCCTTGACGCAGAC
GACCCATCGGTCTAAAAGA -> ACCCATCGGTCTAAAAGAG
TAACTTCTCCACGATCCGG -> AACTTCTCCACGATCCGGA
CAACCGCCGTCGTTGGAGT -> AACCGCCGTCGTTGGAGTT
CGTCGAAGTAGTGCCAGGT -> GTCGAAGTAGTGCCAGGTG
CAGGCCCGCAGATACGATT -> AGGCCCGCAGATACGATTA
GCGTACACCCGAGCTTGGT -> CGTACACCCGAGCTTGGTT
GCAGATACGATTAGTAGTC -> CAGATACGATTAGTAGTCT
CGCCGGTAAGGCCGTTCAC -> GCCGGTAAGGCCGTTCACC
GAGACTGTTGAACGTACAG -> AGACTGTTGAACGTACAGC
TTCTTTTCGCGTAGAAGCG -> TCTTTTCGCGTAGAAGCGC
GCTGTCATGAGGATGTTTT -> CTGTCATGAGGATGTTTTA
GTGCCAGGTGTTACTCGCC -> TGCCAGGTGTTACTCGCCA
GAGCTTGGTTACAAATTGA -> AGCTTGGTTACAAATTGAG
CCGTGTGACACCATGCGGG -> CGTGTGACACCATGCGGGC
ACCGCCAGCGAGAAGCAGT -> CCGCCAGCGAGAAGCAGTA
TTCGTCGATTTATGAATCC -> TCGTCGATTTATGAATCCG
CAAAATATTAGTTTTGGCG -> AAAATATTAGTTTTGGCGG
CCATCGGTCTAAAAATACA -> CATCGGTCTAAAAATACAT
GCGGTCTTGATGGCTCGTG -> CGGTCTTGATGGCTCGTGC
CTTGTGTCCGACTCAAGGA -> TTGTGTCCGACTCAAGGAG
TGGGAATCTCATGATTAAT -> GGGAATCTCATGATTAATT
TTTCGCGTAGAAGCGCATC -> TTCGCGTAGAAGCGCATCA
CAGAATCCTCTGTCATCGA -> AGAATCCTCTGTCATCGAT
CTCGGCGCGCTGTCATGAG -> TCGGCGCGCTGTCATGAGG
GAGCTGGTATTATGGATGG -> AGCTGGTATTATGGATGGC
CCAGAAGTCGCCACCCTTT -> CAGAAGTCGCCACCCTTTG
CGAATCGCGAGAGGAGGGG -> GAATCGCGAGAGGAGGGGC
GCTCGGCGCGCTGTCATGA -> CTCGGCGCGCTGTCATGAG
GCGGTCTTGATGGCTCGGA -> CGGTCTTGATGGCTCGGAT
CTTTGGCCTGCATAGAGCT -> TTTGGCCTGCATAGAGCTG
CTCCGTGCGTACACCCGAG -> TCCGTGCGTACACCCGAGC
CATGCAATGGAGGACATAT -> ATGCAATGGAGGACATATT
TGGAACGTAGGCGGTCTTG -> GGAACGTAGGCGGTCTTGA
CCTATACGAGGCATCAGCA -> CTATACGAGGCATCAGCAG
CGAGCCACTGGTGTATTAT -> GAGCCACTGGTGTATTATA
AGAAGATGTGCTCGAGATC -> GAAGATGTGCTCGAGATCG
CCCCCATCGCGGTCTTGAT -> CCCCATCGCGGTCTTGATG
ATCTGGTCCATTCAAGCTC -> TCTGGTCCATTCAAGCTCC
CTGGCGTGCAGCGCCGGTA -> TGGCGTGCAGCGCCGGTAA
CACCAATTAAAACATAGTC -> ACCAATTAAAACATAGTCT
AGCGTGGTTACGAGGTACG -> GCGTGGTTACGAGGTACGG
AGGTTAAAGTTTCCCGATA -> GGTTAAAGTTTCCCGATAA
GGGCGATCTATAGTGTGCG -> GGCGATCTATAGTGTGCGC
GTCCCTAGTGGTCGGGGCA -> TCCCTAGTGGTCGGGGCAC
GTTACCTCCGTGCGTACAC -> TTACCTCCGTGCGTACACC
AGCGCTTAAAAATCTTGTG -> GCGCTTAAAAATCTTGTGT
TAAGCTACATCTTTATCAT -> AAGCTACATCTTTATCATG
GCCTGATGATTTCATGCGA -> CCTGATGATTTCATGCGAG
AGTCTGGTGAATGGCTGTA -> GTCTGGTGAATGGCTGTAG
TGGTCCATTCAAGCTCCCC -> GGTCCATTCAAGCTCCCCT
TCTCTATCGTGGTCCCTCG -> CTCTATCGTGGTCCCTCGC
AGTCGGGTGGAGTGTATTT -> GTCGGGTGGAGTGTATTTT
TGCGGAGTATATTATGAAG -> GCGGAGTATATTATGAAGG
GCCCACCAATTAAAACATA -> CCCACCAATTAAAACATAG
GATAGAGAACAGCTCTGCG -> ATAGAGAACAGCTCTGCGA
CATAGTCTTTTGACGGCGC -> ATAGTCTTTTGACGGCGCA
ACAAAACTCCTAATGTTAA -> CAAAACTCCTAATGTTAAG
GGCGGTGCTCCCGGTACGC -> GCGGTGCTCCCGGTACGCC
ATCTTGTGTCCGACTCAAG -> TCTTGTGTCCGACTCAAGG
TAATAGCTGTACATACACA -> AATAGCTGTACATACACAT
CTTAATAGCTGTACATACA -> TTAATAGCTGTACATACAC
CTTGATGGCTCGGCCGGCG -> TTGATGGCTCGGCCGGCGA
GGTGAAGGCGTACTTAACG -> GTGAAGGCGTACTTAACGT
AAATCTTTAGTTTCGCGAA -> AATCTTTAGTTTCGCGAAG
CCCTCGTTGGGAATCTCAT -> CCTCGTTGGGAATCTCATG
GTCTTGATGGCTCGTGCGG -> TCTTGATGGCTCGTGCGGT
GACAGAAGACCTCTTTCGG -> ACAGAAGACCTCTTTCGGG
ATCAGCAGAAGGCACGTGC -> TCAGCAGAAGGCACGTGCC
AGTCGCTCGGCGCGCTGTC -> GTCGCTCGGCGCGCTGTCA
TCCACGATCCGGATACCGT -> CCACGATCCGGATACCGTG
ACATAGTCTTTTGACGGCG -> CATAGTCTTTTGACGGCGC
AGCAGGTCCGAGCCACTGG -> GCAGGTCCGAGCCACTGGT
GTGAAGGCGTACTTAACGT -> TGAAGGCGTACTTAACGTT
CCACTAGTCCTGAAGAAGA -> CACTAGTCCTGAAGAAGAT
TCTGATTATACCCCACTGG -> CTGATTATACCCCACTGGG
AGAGAACAGCTCTGCGATA -> GAGAACAGCTCTGCGATAC
ATTGGACGCGTTGAGTCTA -> TTGGACGCGTTGAGTCTAG
TCCATTCAAGCTCCCCTCC -> CCATTCAAGCTCCCCTCCA
GGGAGCTAGCCACTAGTCC -> GGAGCTAGCCACTAGTCCT
TCTCCGCCTTTGGCCTGCA -> CTCCGCCTTTGGCCTGCAT
CGCCTTTGGCCTGCATAGA -> GCCTTTGGCCTGCATAGAG
GGAGCCCATCCAGAAGTCG -> GAGCCCATCCAGAAGTCGC
GGTCAAATTATTGTCATGC -> GTCAAATTATTGTCATGCA
AAGACCTCTTTCGGGATTT -> AGACCTCTTTCGGGATTTC
GGTACGCCCCCATCGCGGT -> GTACGCCCCCATCGCGGTC
ATCGGAGAAGCGGTCTTGA -> TCGGAGAAGCGGTCTTGAT
GAGGCATCAGCAGAAGGCA -> AGGCATCAGCAGAAGGCAC
TGACGGCGCAAAGCCGATA -> GACGGCGCAAAGCCGATAA
ACACACAGACCCATCGGTC -> CACACAGACCCATCGGTCT
CTTAACGTTCCCGTGGTGA -> TTAACGTTCCCGTGGTGAC
AACGATTGCCGTAGTAACT -> ACGATTGCCGTAGTAACTT
GCCGACCATGTCAGACCCA -> CCGACCATGTCAGACCCAT
GCTCACCGCCAGCGAGAAG -> CTCACCGCCAGCGAGAAGC
GATAATCGGAGATATACAT -> ATAATCGGAGATATACATC
GCGAAGGACCCATCGGTAT -> CGAAGGACCCATCGGTATC
ACACATTACGCCGGGCCCA -> CACATTACGCCGGGCCCAT
TGGGCTGGGTTCTCGGCTT -> GGGCTGGGTTCTCGGCTTG
TTCATATCTGGCAGAGTGT -> TCATATCTGGCAGAGTGTT
AGTCTAGAATGATAAGTTA -> GTCTAGAATGATAAGTTAC
GGCCGTAAAATGGTACTCG -> GCCGTAAAATGGTACTCGC
GGGAGGACAGAAGACCTCT -> GGAGGACAGAAGACCTCTT
ACAGCCACCCAAAGCCTTG -> CAGCCACCCAAAGCCTTGA
AGCGCTTATCACACAGAGA -> GCGCTTATCACACAGAGAA
TTACAACCGCCGTCGTTGG -> TACAACCGCCGTCGTTGGA
AGCTTAGAATGGCACTGTA -> GCTTAGAATGGCACTGTAT
CGCGGCCCCATCCCCGCTG -> GCGGCCCCATCCCCGCTGG
TCCCGGTACGCCCCCATCG -> CCCGGTACGCCCCCATCGC
TAGCGTACCTGTGAAATCT -> AGCGTACCTGTGAAATCTC
CGGTCTAAAAGAGACTGTT -> GGTCTAAAAGAGACTGTTG
TCATCGATCTTAGCAGGTC -> CATCGATCTTAGCAGGTCC
GTGCTATGGCTGGCGTGCA -> TGCTATGGCTGGCGTGCAG
ATCTATAGTGTGCGCATTG -> TCTATAGTGTGCGCATTGG
CCCATCGGTCTAAAAATAC -> CCATCGGTCTAAAAATACA
CATGTCAGACCCATCGGTC -> ATGTCAGACCCATCGGTCT
TCATTTTGCCGTGCTATGG -> CATTTTGCCGTGCTATGGC
CATCGGTCTAAAAGTTGGC -> ATCGGTCTAAAAGTTGGCT
ATCAAAGTACCATGGAACG -> TCAAAGTACCATGGAACGT
CGAGTCAGAATCCTCTGTC -> GAGTCAGAATCCTCTGTCA
TCACCCACCGTTTCTAACA -> CACCCACCGTTTCTAACAA
GGCCGACCATGTCAGACCC -> GCCGACCATGTCAGACCCA
CACATTACGCCGGGCCCAT -> ACATTACGCCGGGCCCATC
ATGGGGAGGACAGAAGACC -> TGGGGAGGACAGAAGACCT
ATGGCTGGCGTGCAGCGCC -> TGGCTGGCGTGCAGCGCCG
GCGAATCGCGAGAGGAGGG -> CGAATCGCGAGAGGAGGGG
TACAAATTGAGACATCAGC -> ACAAATTGAGACATCAGCG
TCCTGAAGAAGATGTGCTC -> CCTGAAGAAGATGTGCTCG
TAATCGGAGATATACATCC -> AATCGGAGATATACATCCC
TTATTGGGCTGGGTTCTCG -> TATTGGGCTGGGTTCTCGG
GACTGTTGAACGTACAGCC -> ACTGTTGAACGTACAGCCA
CACGTGCCTGATGATTTCA -> ACGTGCCTGATGATTTCAT
CGAGGTACGGCCGCCGTCA -> GAGGTACGGCCGCCGTCAC
CGAGAAGCAGTATGCGGAG -> GAGAAGCAGTATGCGGAGT
GTCCTGAAGAAGATGTGCT -> TCCTGAAGAAGATGTGCTC
CCATCGCGGTCTTGATGGC -> CATCGCGGTCTTGATGGCT
TATGCGGAGTATATTATGA -> ATGCGGAGTATATTATGAA
GCGATGGTCAAATTATTGT -> CGATGGTCAAATTATTGTC
TCCAATGATAGCAGCCTAG -> CCAATGATAGCAGCCTAGT
GGTACTCGCTCACCGCCAG -> GTACTCGCTCACCGCCAGC
GTGTTCATATCTGGCAGAG -> TGTTCATATCTGGCAGAGT
CCGCCTGGTAACATTACTA -> CGCCTGGTAACATTACTAC
CAGATACGATTAGTAGTCT -> AGATACGATTAGTAGTCTA
TCTTTTGACGGCGCAAAGC -> CTTTTGACGGCGCAAAGCC
GCCCCATCCCCGCTGGTAG -> CCCCATCCCCGCTGGTAGT
GAGCCACTGGTGTATTATA -> AGCCACTGGTGTATTATAT
CTGTACATACACATTACGC -> TGTACATACACATTACGCC
CATCAGCAGAAGGCACGTG -> ATCAGCAGAAGGCACGTGC
CGATCCGGATACCGTGTTC -> GATCCGGATACCGTGTTCA
ATACATTCCAAGATCTCTT -> TACATTCCAAGATCTCTTA
GTAGTAACCTTAGTCGCTC -> TAGTAACCTTAGTCGCTCG
GTTTTAAGTCAGTAGCGCT -> TTTTAAGTCAGTAGCGCTT
AACTCAAAATATTAGTTTT -> ACTCAAAATATTAGTTTTG
TTGATGGCTCGGATTGCAA -> TGATGGCTCGGATTGCAAC
CACACAGAGAATCCGCTAC -> ACACAGAGAATCCGCTACC
GCCAGCGAGAAGCAGTATG -> CCAGCGAGAAGCAGTATGC
TAGTCGCTCGGCGCGCTGT -> AGTCGCTCGGCGCGCTGTC
GAGATCGTTTCTAAAGACA -> AGATCGTTTCTAAAGACAT
CGTAATACAGGAACTTCAG -> GTAATACAGGAACTTCAGA
AGACCTCTTTCGGGATTTC -> GACCTCTTTCGGGATTTCG
CGGTAAGGCCGTTCACCCA -> GGTAAGGCCGTTCACCCAC
GCTTAGAATGGCACTGTAT -> CTTAGAATGGCACTGTATT
TCGAGATCGTTTCTAAAGA -> CGAGATCGTTTCTAAAGAC
TGAGACTTGGCGGCGATGG -> GAGACTTGGCGGCGATGGT
TGTGTCCGACTCAAGGAGA -> GTGTCCGACTCAAGGAGAA
GTCATGCAATGGAGGACAT -> TCATGCAATGGAGGACATA
GCGTTCCATAAACCGGTTA -> CGTTCCATAAACCGGTTAG
GAATGGCACTGTATTCCAT -> AATGGCACTGTATTCCATC
GAAATGGGGAGGACAGAAG -> AAATGGGGAGGACAGAAGA
GGTAGTAACCTTAGTCGCT -> GTAGTAACCTTAGTCGCTC
AAGGCCGACCATGTCAGAC -> AGGCCGACCATGTCAGACC
ACTCCGTCGAAGTAGTGCC -> CTCCGTCGAAGTAGTGCCA
TCAGTAGCGCTTATCACAC -> CAGTAGCGCTTATCACACA
ATCTCTATCGTGGTCCCTC -> TCTCTATCGTGGTCCCTCG
TCTGTCATCGATCTTAGCA -> CTGTCATCGATCTTAGCAG
GTTTCCTTGACGCAGACCC -> TTTCCTTGACGCAGACCCA
TCGGCCGGCGAATGTCAGA -> CGGCCGGCGAATGTCAGAC
TACGATTAGTAGTCTATGC -> ACGATTAGTAGTCTATGCT
GGAGTATATTATGAAGGCT -> GAGTATATTATGAAGGCTC
GAATCTCATGATTAATTTC -> AATCTCATGATTAATTTCG
TTGAACTGCGGTGGGTTTG -> TGAACTGCGGTGGGTTTGA
CCGATAATCGGAGATATAC -> CGATAATCGGAGATATACA
TCTTGATGGCTCGTGCGGT -> CTTGATGGCTCGTGCGGTC
CTAGTCCGTGGGGTGACCT -> TAGTCCGTGGGGTGACCTG
GACCTCTTTCGGGATTTCG -> ACCTCTTTCGGGATTTCGT
TACTTAACGTTCCCGTGGT -> ACTTAACGTTCCCGTGGTG
GATACCGAAGGTTAAAGTT -> ATACCGAAGGTTAAAGTTT
ACATACACATTACGCCGGG -> CATACACATTACGCCGGGC
GAACACAGATCGCGTTCCA -> AACACAGATCGCGTTCCAT
ATTGAAGTCTGGTGAATGG -> TTGAAGTCTGGTGAATGGC
TACCTGTGAAATCTCTATC -> ACCTGTGAAATCTCTATCG
TGATGATTTCATGCGAGAT -> GATGATTTCATGCGAGATA
ATTACTACACACAGGTAGT -> TTACTACACACAGGTAGTC
CCTTGATACCGAAGGTTAA -> CTTGATACCGAAGGTTAAA
CACAATGTTCGTAATACAG -> ACAATGTTCGTAATACAGG
GGACAGAAGACCTCTTTCG -> GACAGAAGACCTCTTTCGG
GGTGTTACTCGCCATTGAA -> GTGTTACTCGCCATTGAAG
TTTCAAACATGAATCAAAG -> TTCAAACATGAATCAAAGT
TTCAAGCTCCCCTCCATGA -> TCAAGCTCCCCTCCATGAG
GTTAAGGAGCGAATCGCGA -> TTAAGGAGCGAATCGCGAG
CGTGGTTACGAGGTACGGC -> GTGGTTACGAGGTACGGCC
GGCACTGTATTCCATCTGG -> GCACTGTATTCCATCTGGT
GGTTCTCGGCTTGTCACAA -> GTTCTCGGCTTGTCACAAT
CTTGTCACAATGTTCGTAA -> TTGTCACAATGTTCGTAAT
GACCATGTCAGACCCATCG -> ACCATGTCAGACCCATCGG
ACAGATCGTGCAGAGTCGG -> CAGATCGTGCAGAGTCGGA
CTTGATGGCTCGGTTTCCT -> TTGATGGCTCGGTTTCCTT
CTTTCGGGATTTCGTCGAT -> TTTCGGGATTTCGTCGATT
TGCCGTAGTAACTTCTCCA -> GCCGTAGTAACTTCTCCAC
TCGTGCGGTCTTGATGGCT -> CGTGCGGTCTTGATGGCTC
GATTGCCGTAGTAACTTCT -> ATTGCCGTAGTAACTTCTC
ACCCATCGGTCTAAAAGGC -> CCCATCGGTCTAAAAGGCC
TCAGCGCTTAAAAATCTTG -> CAGCGCTTAAAAATCTTGT
CCTGCATAGAGCTGGTATT -> CTGCATAGAGCTGGTATTA
ATTGACAAAACTCCTAATG -> TTGACAAAACTCCTAATGT
GCCGTAAAATGGTACTCGC -> CCGTAAAATGGTACTCGCT
CCGGCGAATGTCAGACCCA -> CGGCGAATGTCAGACCCAT
ATCGGAGATATACATCCCT -> TCGGAGATATACATCCCTC
AACGTACAGCCACCCAAAG -> ACGTACAGCCACCCAAAGC
TTATATTGACAAAACTCCT -> TATATTGACAAAACTCCTA
CCATCGAAATGGGGAGGAC -> CATCGAAATGGGGAGGACA
ATCGGTCTAAAAGAGACTG -> TCGGTCTAAAAGAGACTGT
GGTAAGGCCGTTCACCCAC -> GTAAGGCCGTTCACCCACC
ATTTTATACCCTTGTCTCC -> TTTTATACCCTTGTCTCCG
GAACGTAGGCGGTCTTGAT -> AACGTAGGCGGTCTTGATG
GTGGGTTTGATTTCAAACA -> TGGGTTTGATTTCAAACAT
AGAAGCAGTATGCGGAGTA -> GAAGCAGTATGCGGAGTAT
ATGCGGAGTATATTATGAA -> TGCGGAGTATATTATGAAG
GGGCACGAGGGAGCTAGCC -> GGCACGAGGGAGCTAGCCA
TGTCATGCAATGGAGGACA -> GTCATGCAATGGAGGACAT
CATCCAGAAGTCGCCACCC -> ATCCAGAAGTCGCCACCCT
TCGGTTGCGCCTTAATAGC -> CGGTTGCGCCTTAATAGCT
ACCCTCGGTTGCGCCTTAA -> CCCTCGGTTGCGCCTTAAT
CCATTGAAGTCTGGTGAAT -> CATTGAAGTCTGGTGAATG
GGCTAAGCTACATCTTTAT -> GCTAAGCTACATCTTTATC
ACCCTTTGACCCTAGTCCG -> CCCTTTGACCCTAGTCCGT
ACGTGCCTGATGATTTCAT -> CGTGCCTGATGATTTCATG
ACATTACTACACACAGGTA -> CATTACTACACACAGGTAG
AGGGCTAAGCTACATCTTT -> GGGCTAAGCTACATCTTTA
CCGAGCTTGGTTACAAATT -> CGAGCTTGGTTACAAATTG
TAGCAGGTCCGAGCCACTG -> AGCAGGTCCGAGCCACTGG
TTACAAATTGAGACATCAG -> TACAAATTGAGACATCAGC
TTGCGCCTTAATAGCTGTA -> TGCGCCTTAATAGCTGTAC
TCCGCCTTTGGCCTGCATA -> CCGCCTTTGGCCTGCATAG
CGGGTGGAGTGTATTTTCC -> GGGTGGAGTGTATTTTCCG
AGTCAGAATCCTCTGTCAT -> GTCAGAATCCTCTGTCATC
TTAGACTGGTGATTGAACT -> TAGACTGGTGATTGAACTG
TCGGTCTAAAAATACATAT -> CGGTCTAAAAATACATATA
GGCGCAAAGCCGATAATCG -> GCGCAAAGCCGATAATCGG
GAGGACAGAAGACCTCTTT -> AGGACAGAAGACCTCTTTC
GAACTTCAGAGGCTGTCCG -> AACTTCAGAGGCTGTCCGC
TTTATCATGACCCTCGGTT -> TTATCATGACCCTCGGTTG
CATTGGACGCGTTGAGTCT -> ATTGGACGCGTTGAGTCTA
AGAGTCGGAAAGTTGTTAA -> GAGTCGGAAAGTTGTTAAA
GAGAACAGCTCTGCGATAC -> AGAACAGCTCTGCGATACA
GTAGCATGCAGGTGAAGGC -> TAGCATGCAGGTGAAGGCG
TCTTAGACTGGTGATTGAA -> CTTAGACTGGTGATTGAAC
ATGAAGGCTCTTTCTTTTC -> TGAAGGCTCTTTCTTTTCG
CATAGAGCTGGTATTATGG -> ATAGAGCTGGTATTATGGA
GCGTAGAAGCGCATCAATC -> CGTAGAAGCGCATCAATCG
ACTGCGGTGGGTTTGATTT -> CTGCGGTGGGTTTGATTTC
TGATAAGTTACAACCGCCG -> GATAAGTTACAACCGCCGT
CGCCCCCATCGCGGTCTTG -> GCCCCCATCGCGGTCTTGA
TATCATGACCCTCGGTTGC -> ATCATGACCCTCGGTTGCG
CTAAGCTACATCTTTATCA -> TAAGCTACATCTTTATCAT
CAAGATTCATTTTGCCGTG -> AAGATTCATTTTGCCGTGC
CCAGGTGTTACTCGCCATT -> CAGGTGTTACTCGCCATTG
CTGGGCACGAGTCAGAATC -> TGGGCACGAGTCAGAATCC
GTTTCTAACAAAAGCCTAT -> TTTCTAACAAAAGCCTATA
TGCAGCGCCGGTAAGGCCG -> GCAGCGCCGGTAAGGCCGT
AAAAATACATATATGAAGG -> AAAATACATATATGAAGGG
GAAGCAGTATGCGGAGTAT -> AAGCAGTATGCGGAGTATA
TCAAAGTACCATGGAACGT -> CAAAGTACCATGGAACGTA
TAGAATGGTAAGAGTTAGG -> AGAATGGTAAGAGTTAGGA
GGTATCTGATTATACCCCA -> GTATCTGATTATACCCCAC
TAAACCGGTTAGATGCCCA -> AAACCGGTTAGATGCCCAC
ATATTAAAAAACTAAATAT -> TATTAAAAAACTAAATATC
CACTAGTCCTGAAGAAGAT -> ACTAGTCCTGAAGAAGATG
GATGCCCACCAATTAAAAC -> ATGCCCACCAATTAAAACA
AAGGAGAAGGCAACTCCGT -> AGGAGAAGGCAACTCCGTC
TACTCGCTCACCGCCAGCG -> ACTCGCTCACCGCCAGCGA
TGGCTGGCGTGCAGCGCCG -> GGCTGGCGTGCAGCGCCGG
CCATCGGTATCTGATTATA -> CATCGGTATCTGATTATAC
GCTTGGTTACAAATTGAGA -> CTTGGTTACAAATTGAGAC
GGTACGGCCGCCGTCACTC -> GTACGGCCGCCGTCACTCT
CAGGTGAAGGCGTACTTAA -> AGGTGAAGGCGTACTTAAC
TTGACGGCGCAAAGCCGAT -> TGACGGCGCAAAGCCGATA
GTCTAAAAGGCCGACCATG -> TCTAAAAGGCCGACCATGT
CATATATGAAGGGCTAAGC -> ATATATGAAGGGCTAAGCT
CATCGAAATGGGGAGGACA -> ATCGAAATGGGGAGGACAG
TATCTGATTATACCCCACT -> ATCTGATTATACCCCACTG
GGCGGCGATGGTCAAATTA -> GCGGCGATGGTCAAATTAT
AGTTATTGGGCTGGGTTCT -> GTTATTGGGCTGGGTTCTC
GGAGAAGGCAACTCCGTCG -> GAGAAGGCAACTCCGTCGA
TAACTCAAAATATTAGTTT -> AACTCAAAATATTAGTTTT
TAGTAACCTTAGTCGCTCG -> AGTAACCTTAGTCGCTCGG
TAAGTCAGTAGCGCTTATC -> AAGTCAGTAGCGCTTATCA
GGCGGCCGCCGGTCACAGA -> GCGGCCGCCGGTCACAGAA
TTCAAACATGAATCAAAGT -> TCAAACATGAATCAAAGTA
CGGGCCGCCTGGTAACATT -> GGGCCGCCTGGTAACATTA
CACGAGGGAGCTAGCCACT -> ACGAGGGAGCTAGCCACTA
CATCGGTATCTGATTATAC -> ATCGGTATCTGATTATACC
ACCCATCGGTCTAAAAGTT -> CCCATCGGTCTAAAAGTTG
AATGGTAAGAGTTAGGACT -> ATGGTAAGAGTTAGGACTG
TTGGCGGTGCTCCCGGTAC -> TGGCGGTGCTCCCGGTACG
TACAACCGCCGTCGTTGGA -> ACAACCGCCGTCGTTGGAG
ACATATATGAAGGGCTAAG -> CATATATGAAGGGCTAAGC
TTTCCGTGTGACACCATGC -> TTCCGTGTGACACCATGCG
CCGTGTAGGAGCCCATCCA -> CGTGTAGGAGCCCATCCAG
CATATTAAAAAACTAAATA -> ATATTAAAAAACTAAATAT
CCTTTGGCCTGCATAGAGC -> CTTTGGCCTGCATAGAGCT
AGACTGTTGAACGTACAGC -> GACTGTTGAACGTACAGCC
ATTTCATGCGAGATAGAGA -> TTTCATGCGAGATAGAGAA
CCCATCGGTCTAAAAGGCC -> CCATCGGTCTAAAAGGCCG
TAGCTTAGAATGGCACTGT -> AGCTTAGAATGGCACTGTA
CGTGCTATGGCTGGCGTGC -> GTGCTATGGCTGGCGTGCA
CTGAAATGGGCGCAGCTGA -> TGAAATGGGCGCAGCTGAG
GTGGTTACGAGGTACGGCC -> TGGTTACGAGGTACGGCCG
AGTGCCAGGTGTTACTCGC -> GTGCCAGGTGTTACTCGCC
GCGCATTGGACGCGTTGAG -> CGCATTGGACGCGTTGAGT
GTCACTCTAGGTACGTCCC -> TCACTCTAGGTACGTCCCT
CTTAGCAGGTCCGAGCCAC -> TTAGCAGGTCCGAGCCACT
TCGTGCAGAGTCGGAAAGT -> CGTGCAGAGTCGGAAAGTT
TAGCAGCCTAGTCGGGTGG -> AGCAGCCTAGTCGGGTGGA
CCTGAAGAAGATGTGCTCG -> CTGAAGAAGATGTGCTCGA
AGGTAGTCTAGAATGATAA -> GGTAGTCTAGAATGATAAG
AAGATTCATTTTGCCGTGC -> AGATTCATTTTGCCGTGCT
GACACCATGCGGGCCGTAA -> ACACCATGCGGGCCGTAAA
CTGAAGAAGATGTGCTCGA -> TGAAGAAGATGTGCTCGAG
CCCATCGGTCTAAAAGAGA -> CCATCGGTCTAAAAGAGAC
CGAGGGAGCTAGCCACTAG -> GAGGGAGCTAGCCACTAGT
CAGGTCCGAGCCACTGGTG -> AGGTCCGAGCCACTGGTGT
TGGCTGTAGCGTGGTTACG -> GGCTGTAGCGTGGTTACGA
ACTAGCTTAGAATGGCACT -> CTAGCTTAGAATGGCACTG
GCCGGCGAATGTCAGACCC -> CCGGCGAATGTCAGACCCA
CAGAGAATCCGCTACCACT -> AGAGAATCCGCTACCACTG
ATTTTGCCGTGCTATGGCT -> TTTTGCCGTGCTATGGCTG
GACGCAGACCCATCGGTCT -> ACGCAGACCCATCGGTCTA
TAAGGAGCGAATCGCGAGA -> AAGGAGCGAATCGCGAGAG
ACATTCCAAGATCTCTTAG -> CATTCCAAGATCTCTTAGT
TCTTTCTTTTCGCGTAGAA -> CTTTCTTTTCGCGTAGAAG
GATGGCTCGGATTGCAACA -> ATGGCTCGGATTGCAACAC
GCTGGTAGTAACCTTAGTC -> CTGGTAGTAACCTTAGTCG
ACCCTAGTCCGTGGGGTGA -> CCCTAGTCCGTGGGGTGAC
GTATCTGATTATACCCCAC -> TATCTGATTATACCCCACT
AGAACAGCTCTGCGATACA -> GAACAGCTCTGCGATACAT
AGGCCGTTCACCCACCGTT -> GGCCGTTCACCCACCGTTT
ATATCTGGCAGAGTGTTGT -> TATCTGGCAGAGTGTTGTA
CGGTTAGATGCCCACCAAT -> GGTTAGATGCCCACCAATT
ATTTCAAACATGAATCAAA -> TTTCAAACATGAATCAAAG
GTGCGCATTGGACGCGTTG -> TGCGCATTGGACGCGTTGA
GCTAGCCACTAGTCCTGAA -> CTAGCCACTAGTCCTGAAG
TAAAAAACTAAATATCGGA -> AAAAAACTAAATATCGGAG
CAATGGAGGACATATTAAA -> AATGGAGGACATATTAAAA
ACCAGGCCCGCAGATACGA -> CCAGGCCCGCAGATACGAT
TCTTAGTTACCTCCGTGCG -> CTTAGTTACCTCCGTGCGT
AGGGAGCTAGCCACTAGTC -> GGGAGCTAGCCACTAGTCC
ACCGAAGGTTAAAGTTTCC -> CCGAAGGTTAAAGTTTCCC
TATGAAGGCTCTTTCTTTT -> ATGAAGGCTCTTTCTTTTC
GCTTTAACGTAGCATGCAG -> CTTTAACGTAGCATGCAGG
AAGTTGGCTTTAACGTAGC -> AGTTGGCTTTAACGTAGCA
AAACTCCTAATGTTAAGGA -> AACTCCTAATGTTAAGGAG
GAATGTCAGACCCATCGGT -> AATGTCAGACCCATCGGTC
CGGTGGGTTTGATTTCAAA -> GGTGGGTTTGATTTCAAAC
CGATCTATAGTGTGCGCAT -> GATCTATAGTGTGCGCATT
ACTCTAGGTACGTCCCTAG -> CTCTAGGTACGTCCCTAGT
TTAAGTCAGTAGCGCTTAT -> TAAGTCAGTAGCGCTTATC
GCAACACACAGACCCATCG -> CAACACACAGACCCATCGG
GGTCACAGAACACAGATCG -> GTCACAGAACACAGATCGC
AGTTTTGGCGGTGCTCCCG -> GTTTTGGCGGTGCTCCCGG
GATACGATTAGTAGTCTAT -> ATACGATTAGTAGTCTATG
ATACATCCCTCGTTGGGAA -> TACATCCCTCGTTGGGAAT
AAATGGTACTCGCTCACCG -> AATGGTACTCGCTCACCGC
AACATTACTACACACAGGT -> ACATTACTACACACAGGTA
TCTAGCGTACCTGTGAAAT -> CTAGCGTACCTGTGAAATC
CCTGGTAACATTACTACAC -> CTGGTAACATTACTACACA
TCCCTCGTTGGGAATCTCA -> CCCTCGTTGGGAATCTCAT
GCCACCCTTTGACCCTAGT -> CCACCCTTTGACCCTAGTC
GCATGCAGGTGAAGGCGTA -> CATGCAGGTGAAGGCGTAC
GCTACCACTGGGCACGAGT -> CTACCACTGGGCACGAGTC
CGCGTTGAGTCTAGCGTAC -> GCGTTGAGTCTAGCGTACC
TGTTAAAGTAACTCAAAAT -> GTTAAAGTAACTCAAAATA
CGGGATTTCGTCGATTTAT -> GGGATTTCGTCGATTTATG
GCACTGTATTCCATCTGGT -> CACTGTATTCCATCTGGTC
ATGTTCGTAATACAGGAAC -> TGTTCGTAATACAGGAACT
GCCGGTCACAGAACACAGA -> CCGGTCACAGAACACAGAT
GGTGGAGTGTATTTTCCGT -> GTGGAGTGTATTTTCCGTG
ATTTCGTCGATTTATGAAT -> TTTCGTCGATTTATGAATC
AGTATATTATGAAGGCTCT -> GTATATTATGAAGGCTCTT
GTAGCGCTTATCACACAGA -> TAGCGCTTATCACACAGAG
GACTCCGCGGCCCCATCCC -> ACTCCGCGGCCCCATCCCC
CCCGTGGTGACTCCGCGGC -> CCGTGGTGACTCCGCGGCC
GCTTATCACACAGAGAATC -> CTTATCACACAGAGAATCC
GATAAATCTTTAGTTTCGC -> ATAAATCTTTAGTTTCGCG
CCAATGATAGCAGCCTAGT -> CAATGATAGCAGCCTAGTC
CCCATCGCGGTCTTGATGG -> CCATCGCGGTCTTGATGGC
AAAGTTGTTAAAGTAACTC -> AAGTTGTTAAAGTAACTCA
CTCTTTCGGGATTTCGTCG -> TCTTTCGGGATTTCGTCGA
TGTAGCGTGGTTACGAGGT -> GTAGCGTGGTTACGAGGTA
GGGCCGCCTGGTAACATTA -> GGCCGCCTGGTAACATTAC
CCCGAGCTTGGTTACAAAT -> CCGAGCTTGGTTACAAATT
CTCTTAGTTACCTCCGTGC -> TCTTAGTTACCTCCGTGCG
TCTCCACGATCCGGATACC -> CTCCACGATCCGGATACCG
GAGTTAGGACTGAAATGGG -> AGTTAGGACTGAAATGGGC
GCCACTGGTGTATTATATT -> CCACTGGTGTATTATATTG
CCTCGGTTGCGCCTTAATA -> CTCGGTTGCGCCTTAATAG
CTCGTGCGGTCTTGATGGC -> TCGTGCGGTCTTGATGGCT
GAAGGGCTAAGCTACATCT -> AAGGGCTAAGCTACATCTT
ACAGGTAGTCTAGAATGAT -> CAGGTAGTCTAGAATGATA
TCGCGAGAGGAGGGGCGAT -> CGCGAGAGGAGGGGCGATC
GTTACAAATTGAGACATCA -> TTACAAATTGAGACATCAG
ATGGAACGTAGGCGGTCTT -> TGGAACGTAGGCGGTCTTG
TTTTAAGTCAGTAGCGCTT -> TTTAAGTCAGTAGCGCTTA
GCAGGTCCGAGCCACTGGT -> CAGGTCCGAGCCACTGGTG
AGTACCATGGAACGTAGGC -> GTACCATGGAACGTAGGCG
ATTTATGAATCCGGGCCGC -> TTTATGAATCCGGGCCGCC
CTAGCTTAGAATGGCACTG -> TAGCTTAGAATGGCACTGT
ACGTAGCATGCAGGTGAAG -> CGTAGCATGCAGGTGAAGG
GTCGCTCGGCGCGCTGTCA -> TCGCTCGGCGCGCTGTCAT
AGGCCGACCATGTCAGACC -> GGCCGACCATGTCAGACCC
AACGTTCCCGTGGTGACTC -> ACGTTCCCGTGGTGACTCC
TAACCTTAGTCGCTCGGCG -> AACCTTAGTCGCTCGGCGC
CGAAGGTTAAAGTTTCCCG -> GAAGGTTAAAGTTTCCCGA
TTGTAATACCAGGCCCGCA -> TGTAATACCAGGCCCGCAG
GCGGCGATGGTCAAATTAT -> CGGCGATGGTCAAATTATT
CCCTCACGCAGGTACAAGA -> CCTCACGCAGGTACAAGAT
GTTATTGGGCTGGGTTCTC -> TTATTGGGCTGGGTTCTCG
ATAGAGAACAGCTCTGCGA -> TAGAGAACAGCTCTGCGAT
GCTAGAATGGTAAGAGTTA -> CTAGAATGGTAAGAGTTAG
TCCGCTTGACCCTCACGCA -> CCGCTTGACCCTCACGCAG
CCAAAGCCTTGATACCGAA -> CAAAGCCTTGATACCGAAG
CCGCCTTTGGCCTGCATAG -> CGCCTTTGGCCTGCATAGA
GCGGCCCCATCCCCGCTGG -> CGGCCCCATCCCCGCTGGT
ATCCAGAAGTCGCCACCCT -> TCCAGAAGTCGCCACCCTT
GGTGCTCCCGGTACGCCCC -> GTGCTCCCGGTACGCCCCC
CTCAAAATATTAGTTTTGG -> TCAAAATATTAGTTTTGGC
TGGTCCCTCGCTAACTAGC -> GGTCCCTCGCTAACTAGCT
AACTTCTCCACGATCCGGA -> ACTTCTCCACGATCCGGAT
GTACCATGGAACGTAGGCG -> TACCATGGAACGTAGGCGG
TGTAATACCAGGCCCGCAG -> GTAATACCAGGCCCGCAGA
AGTATGCGGAGTATATTAT -> GTATGCGGAGTATATTATG
AATTTCGTTCTTAGACTGG -> ATTTCGTTCTTAGACTGGT
TATCGTGGTCCCTCGCTAA -> ATCGTGGTCCCTCGCTAAC
GCGCTGTCATGAGGATGTT -> CGCTGTCATGAGGATGTTT
TATTCCATCTGGTCCATTC -> ATTCCATCTGGTCCATTCA
GGCTCGGCCGGCGAATGTC -> GCTCGGCCGGCGAATGTCA
CTTTTCGCGTAGAAGCGCA -> TTTTCGCGTAGAAGCGCAT
CGTTGAGTCTAGCGTACCT -> GTTGAGTCTAGCGTACCTG
TCGATTTATGAATCCGGGC -> CGATTTATGAATCCGGGCC
TGGGTTTGATTTCAAACAT -> GGGTTTGATTTCAAACATG
CTCCGCCTTTGGCCTGCAT -> TCCGCCTTTGGCCTGCATA
AGCCTTGATACCGAAGGTT -> GCCTTGATACCGAAGGTTA
GCCGTGCTATGGCTGGCGT -> CCGTGCTATGGCTGGCGTG
ATGCGAGATAGAGAACAGC -> TGCGAGATAGAGAACAGCT
ACTGAAATGGGCGCAGCTG -> CTGAAATGGGCGCAGCTGA
CTTAGACTGGTGATTGAAC -> TTAGACTGGTGATTGAACT
CGGATACCGTGTTCATATC -> GGATACCGTGTTCATATCT
GAAGCGGTCTTGATGGCTC -> AAGCGGTCTTGATGGCTCG
ATAATCGGAGATATACATC -> TAATCGGAGATATACATCC
GGGTTTGATTTCAAACATG -> GGTTTGATTTCAAACATGA
TTACCTCCGTGCGTACACC -> TACCTCCGTGCGTACACCC
TGAAGGCTCTTTCTTTTCG -> GAAGGCTCTTTCTTTTCGC
GTACATACACATTACGCCG -> TACATACACATTACGCCGG
GAATGATAAGTTACAACCG -> AATGATAAGTTACAACCGC
GTGCTCCCGGTACGCCCCC -> TGCTCCCGGTACGCCCCCA
AGTCTAGCGTACCTGTGAA -> GTCTAGCGTACCTGTGAAA
AACAAAAGCCTATACGAGG -> ACAAAAGCCTATACGAGGC
GCATCAATCGTCCACCGAG -> CATCAATCGTCCACCGAGA
AGCATGCAGGTGAAGGCGT -> GCATGCAGGTGAAGGCGTA
ATACGATTAGTAGTCTATG -> TACGATTAGTAGTCTATGC
AGTTAGGACTGAAATGGGC -> GTTAGGACTGAAATGGGCG
ATTGGGCTGGGTTCTCGGC -> TTGGGCTGGGTTCTCGGCT
AGTCGGAAAGTTGTTAAAG -> GTCGGAAAGTTGTTAAAGT
AAATATTAGTTTTGGCGGT -> AATATTAGTTTTGGCGGTG
GAATCCGCTACCACTGGGC -> AATCCGCTACCACTGGGCA
CATGCGAGATAGAGAACAG -> ATGCGAGATAGAGAACAGC
CGCTGGTAGTAACCTTAGT -> GCTGGTAGTAACCTTAGTC
CTATGCTAGAATGGTAAGA -> TATGCTAGAATGGTAAGAG
TCATGATTAATTTCGTTCT -> CATGATTAATTTCGTTCTT
ACCTCTGTTATTTTATACC -> CCTCTGTTATTTTATACCC
GTCATCGATCTTAGCAGGT -> TCATCGATCTTAGCAGGTC
TTTTCCGTGTGACACCATG -> TTTCCGTGTGACACCATGC
AGGCTGTCCGCTTGACCCT -> GGCTGTCCGCTTGACCCTC
GCTTGTCACAATGTTCGTA -> CTTGTCACAATGTTCGTAA
GGTCTTGATGGCTCGGTTT -> GTCTTGATGGCTCGGTTTC
CGCCGTCACTCTAGGTACG -> GCCGTCACTCTAGGTACGT
TCCCTAGTGGTCGGGGCAC -> CCCTAGTGGTCGGGGCACG
GGGGCGATCTATAGTGTGC -> GGGCGATCTATAGTGTGCG
TCTAGAATGATAAGTTACA -> CTAGAATGATAAGTTACAA
TTTTATACCCTTGTCTCCG -> TTTATACCCTTGTCTCCGC
CCATGTCAGACCCATCGGT -> CATGTCAGACCCATCGGTC
AAGTAACTCAAAATATTAG -> AGTAACTCAAAATATTAGT
CTTGTCTCCGCCTTTGGCC -> TTGTCTCCGCCTTTGGCCT
GGAATCTCATGATTAATTT -> GAATCTCATGATTAATTTC
TCGGGATTTCGTCGATTTA -> CGGGATTTCGTCGATTTAT
AACGTAGCATGCAGGTGAA -> ACGTAGCATGCAGGTGAAG
AATGGCTGTAGCGTGGTTA -> ATGGCTGTAGCGTGGTTAC
GTGGTCGGGGCACGAGGGA -> TGGTCGGGGCACGAGGGAG
GAAGAAGATGTGCTCGAGA -> AAGAAGATGTGCTCGAGAT
GGCGATGGTCAAATTATTG -> GCGATGGTCAAATTATTGT
TCCGCTACCACTGGGCACG -> CCGCTACCACTGGGCACGA
CGCTCGGCGCGCTGTCATG -> GCTCGGCGCGCTGTCATGA
AAGATGTGCTCGAGATCGT -> AGATGTGCTCGAGATCGTT
CAGCCACCCAAAGCCTTGA -> AGCCACCCAAAGCCTTGAT
CGGGGCACGAGGGAGCTAG -> GGGGCACGAGGGAGCTAGC
CGCCGTCGTTGGAGTTATT -> GCCGTCGTTGGAGTTATTG
CAGCGCTTAAAAATCTTGT -> AGCGCTTAAAAATCTTGTG
AATGGCACTGTATTCCATC -> ATGGCACTGTATTCCATCT
CGGTCTAAAAGTTGGCTTT -> GGTCTAAAAGTTGGCTTTA
GAAAGTTGTTAAAGTAACT -> AAAGTTGTTAAAGTAACTC
ACCGTGTAGGAGCCCATCC -> CCGTGTAGGAGCCCATCCA
TAAAAATCTTGTGTCCGAC -> AAAAATCTTGTGTCCGACT
GCGTTGAGTCTAGCGTACC -> CGTTGAGTCTAGCGTACCT
CGCCGGGCCCATCGAAATG -> GCCGGGCCCATCGAAATGG
CGAAGTAGTGCCAGGTGTT -> GAAGTAGTGCCAGGTGTTA
TGTGCGCATTGGACGCGTT -> GTGCGCATTGGACGCGTTG
ATGAGACTTGGCGGCGATG -> TGAGACTTGGCGGCGATGG
TGTGAAATCTCTATCGTGG -> GTGAAATCTCTATCGTGGT
CTAAAAGTTGGCTTTAACG -> TAAAAGTTGGCTTTAACGT
TGGTAACATTACTACACAC -> GGTAACATTACTACACACA
ACGTTCCCGTGGTGACTCC -> CGTTCCCGTGGTGACTCCG
GTGACACCATGCGGGCCGT -> TGACACCATGCGGGCCGTA
AAGTCTGGTGAATGGCTGT -> AGTCTGGTGAATGGCTGTA
ACGATCCGGATACCGTGTT -> CGATCCGGATACCGTGTTC
TTGCCGTGCTATGGCTGGC -> TGCCGTGCTATGGCTGGCG
GCCGCCTGGTAACATTACT -> CCGCCTGGTAACATTACTA
AAGCGGTCTTGATGGCTCG -> AGCGGTCTTGATGGCTCGG
ATATATGAAGGGCTAAGCT -> TATATGAAGGGCTAAGCTA
CGGCCGCCGTCACTCTAGG -> GGCCGCCGTCACTCTAGGT
CATGAATCAAAGTACCATG -> ATGAATCAAAGTACCATGG
GTTCGTAATACAGGAACTT -> TTCGTAATACAGGAACTTC
TGAAGGCGTACTTAACGTT -> GAAGGCGTACTTAACGTTC
GCGAGAAGCAGTATGCGGA -> CGAGAAGCAGTATGCGGAG
CTTTAGTTTCGCGAAGGAC -> TTTAGTTTCGCGAAGGACC
CCTCTGTTATTTTATACCC -> CTCTGTTATTTTATACCCT
ACAGATCGCGTTCCATAAA -> CAGATCGCGTTCCATAAAC
AGAGGCTGTCCGCTTGACC -> GAGGCTGTCCGCTTGACCC
AGAAGGCACGTGCCTGATG -> GAAGGCACGTGCCTGATGA
CACTGTATTCCATCTGGTC -> ACTGTATTCCATCTGGTCC
GCAGACCCATCGGTCTAAA -> CAGACCCATCGGTCTAAAA
TCTAAAAGTTGGCTTTAAC -> CTAAAAGTTGGCTTTAACG
GATCTTAGCAGGTCCGAGC -> ATCTTAGCAGGTCCGAGCC
CAACTCCGTCGAAGTAGTG -> AACTCCGTCGAAGTAGTGC
AAGCGCATCAATCGTCCAC -> AGCGCATCAATCGTCCACC
GTTTTGGCGGTGCTCCCGG -> TTTTGGCGGTGCTCCCGGT
ATTATTGTCATGCAATGGA -> TTATTGTCATGCAATGGAG
GTCTAAAAATACATATATG -> TCTAAAAATACATATATGA
CGTCGTTGGAGTTATTGGG -> GTCGTTGGAGTTATTGGGC
CTGTAGCGTGGTTACGAGG -> TGTAGCGTGGTTACGAGGT
TGCCAGGTGTTACTCGCCA -> GCCAGGTGTTACTCGCCAT
CCTCTGTCATCGATCTTAG -> CTCTGTCATCGATCTTAGC
GCGGTCTTGATGGCTCGGT -> CGGTCTTGATGGCTCGGTT
AACGTAGGCGGTCTTGATG -> ACGTAGGCGGTCTTGATGG
GCAGCTGAGACTTTACCGT -> CAGCTGAGACTTTACCGTG
TTGCCGTAGTAACTTCTCC -> TGCCGTAGTAACTTCTCCA
CCATTCAAGCTCCCCTCCA -> CATTCAAGCTCCCCTCCAT
AGACTGGTGATTGAACTGC -> GACTGGTGATTGAACTGCG
GTCAAATTATTGTCATGCA -> TCAAATTATTGTCATGCAA
CTAGTCGGGTGGAGTGTAT -> TAGTCGGGTGGAGTGTATT
GCTGGCGTGCAGCGCCGGT -> CTGGCGTGCAGCGCCGGTA
AACACACAGACCCATCGGT -> ACACACAGACCCATCGGTC
TATACCTCTGTTATTTTAT -> ATACCTCTGTTATTTTATA
TCTGGCAGAGTGTTGTAAT -> CTGGCAGAGTGTTGTAATA
CGGAAAGTTGTTAAAGTAA -> GGAAAGTTGTTAAAGTAAC
GTACTCGCTCACCGCCAGC -> TACTCGCTCACCGCCAGCG
TTAGCAGGTCCGAGCCACT -> TAGCAGGTCCGAGCCACTG
AGTCTATGCTAGAATGGTA -> GTCTATGCTAGAATGGTAA
TACCATGGAACGTAGGCGG -> ACCATGGAACGTAGGCGGT
AATGTTAAGGAGCGAATCG -> ATGTTAAGGAGCGAATCGC
GTTCATATCTGGCAGAGTG -> TTCATATCTGGCAGAGTGT
AGGAACTTCAGAGGCTGTC -> GGAACTTCAGAGGCTGTCC
AAGGTTAAAGTTTCCCGAT -> AGGTTAAAGTTTCCCGATA
GTACAGCCACCCAAAGCCT -> TACAGCCACCCAAAGCCTT
TTTGACCCTAGTCCGTGGG -> TTGACCCTAGTCCGTGGGG
CCACCCAAAGCCTTGATAC -> CACCCAAAGCCTTGATACC
CGTGCAGCGCCGGTAAGGC -> GTGCAGCGCCGGTAAGGCC
AGTGTTGTAATACCAGGCC -> GTGTTGTAATACCAGGCCC
TCCATGAGACTTGGCGGCG -> CCATGAGACTTGGCGGCGA
AAAGAGACTGTTGAACGTA -> AAGAGACTGTTGAACGTAC
TCCGACTCAAGGAGAAGGC -> CCGACTCAAGGAGAAGGCA
ATGATTTCATGCGAGATAG -> TGATTTCATGCGAGATAGA
AGCTCTGCGATACATTCCA -> GCTCTGCGATACATTCCAA
AGAGCTGGTATTATGGATG -> GAGCTGGTATTATGGATGG
TTCCAAGATCTCTTAGTTA -> TCCAAGATCTCTTAGTTAC
CCCCGCTGGTAGTAACCTT -> CCCGCTGGTAGTAACCTTA
CGAAATGGGGAGGACAGAA -> GAAATGGGGAGGACAGAAG
CGCAGACCCATCGGTCTAA -> GCAGACCCATCGGTCTAAA
ATTGAACTGCGGTGGGTTT -> TTGAACTGCGGTGGGTTTG
CGGCCGCCGGTCACAGAAC -> GGCCGCCGGTCACAGAACA
ATCAGCGCTTAAAAATCTT -> TCAGCGCTTAAAAATCTTG
GAGTCAGAATCCTCTGTCA -> AGTCAGAATCCTCTGTCAT
AATCCGGGCCGCCTGGTAA -> ATCCGGGCCGCCTGGTAAC
GCGTGCAGCGCCGGTAAGG -> CGTGCAGCGCCGGTAAGGC
AGACTTTACCGTGTAGGAG -> GACTTTACCGTGTAGGAGC
GTCGGGGCACGAGGGAGCT -> TCGGGGCACGAGGGAGCTA
GGGCTAAGCTACATCTTTA -> GGCTAAGCTACATCTTTAT
GTCGGGTGGAGTGTATTTT -> TCGGGTGGAGTGTATTTTC
GACCCATCGGTCTAAAAGG -> ACCCATCGGTCTAAAAGGC
CTCCTAATGTTAAGGAGCG -> TCCTAATGTTAAGGAGCGA
GAGTATATTATGAAGGCTC -> AGTATATTATGAAGGCTCT
CTCAAGGAGAAGGCAACTC -> TCAAGGAGAAGGCAACTCC
ACTACACACAGGTAGTCTA -> CTACACACAGGTAGTCTAG
TAGTAGTCTATGCTAGAAT -> AGTAGTCTATGCTAGAATG
AAGGCCGTTCACCCACCGT -> AGGCCGTTCACCCACCGTT
TAACAAAAGCCTATACGAG -> AACAAAAGCCTATACGAGG
ACAGAAGACCTCTTTCGGG -> CAGAAGACCTCTTTCGGGA
TACACACAGGTAGTCTAGA -> ACACACAGGTAGTCTAGAA
CGTCACTCTAGGTACGTCC -> GTCACTCTAGGTACGTCCC
ATGGCTCGGTTTCCTTGAC -> TGGCTCGGTTTCCTTGACG
CTCCACGATCCGGATACCG -> TCCACGATCCGGATACCGT
GTAGGAGCCCATCCAGAAG -> TAGGAGCCCATCCAGAAGT
ACCCTCACGCAGGTACAAG -> CCCTCACGCAGGTACAAGA
GCCACTAGTCCTGAAGAAG -> CCACTAGTCCTGAAGAAGA
CAGAAGTCGCCACCCTTTG -> AGAAGTCGCCACCCTTTGA
AATCAAAGTACCATGGAAC -> ATCAAAGTACCATGGAACG
CCGTAAAATGGTACTCGCT -> CGTAAAATGGTACTCGCTC
CGCCACCCTTTGACCCTAG -> GCCACCCTTTGACCCTAGT
TCGGCGCGCTGTCATGAGG -> CGGCGCGCTGTCATGAGGA
GATTAATTTCGTTCTTAGA -> ATTAATTTCGTTCTTAGAC
GCAGGTGAAGGCGTACTTA -> CAGGTGAAGGCGTACTTAA
ACTGTTGAACGTACAGCCA -> CTGTTGAACGTACAGCCAC
ATCTCATGATTAATTTCGT -> TCTCATGATTAATTTCGTT
ACATATTAAAAAACTAAAT -> CATATTAAAAAACTAAATA
GTTAAAGTAACTCAAAATA -> TTAAAGTAACTCAAAATAT
GTCTTTTGACGGCGCAAAG -> TCTTTTGACGGCGCAAAGC
TGTGACACCATGCGGGCCG -> GTGACACCATGCGGGCCGT
GTAATACCAGGCCCGCAGA -> TAATACCAGGCCCGCAGAT
CAAGGAGAAGGCAACTCCG -> AAGGAGAAGGCAACTCCGT
ACACAGGTAGTCTAGAATG -> CACAGGTAGTCTAGAATGA
GCCTGCATAGAGCTGGTAT -> CCTGCATAGAGCTGGTATT
AGTCAGTAGCGCTTATCAC -> GTCAGTAGCGCTTATCACA
CTAAATATCGGAGAAGCGG -> TAAATATCGGAGAAGCGGT
ATGGCGGCCGCCGGTCACA -> TGGCGGCCGCCGGTCACAG
CAGCTCTGCGATACATTCC -> AGCTCTGCGATACATTCCA
AGATCTCTTAGTTACCTCC -> GATCTCTTAGTTACCTCCG
CGGCCCCATCCCCGCTGGT -> GGCCCCATCCCCGCTGGTA
CTTAAAAATCTTGTGTCCG -> TTAAAAATCTTGTGTCCGA
ATACCCTTGTCTCCGCCTT -> TACCCTTGTCTCCGCCTTT
CGTAGGCGGTCTTGATGGC -> GTAGGCGGTCTTGATGGCT
TTGTGTCCGACTCAAGGAG -> TGTGTCCGACTCAAGGAGA
ATGGATGGCGGCCGCCGGT -> TGGATGGCGGCCGCCGGTC
CGAAGGACCCATCGGTATC -> GAAGGACCCATCGGTATCT
GAAGGCGTACTTAACGTTC -> AAGGCGTACTTAACGTTCC
AGGTGAAGGCGTACTTAAC -> GGTGAAGGCGTACTTAACG
TCCTTGACGCAGACCCATC -> CCTTGACGCAGACCCATCG
TCCGTGGGGTGACCTGAGA -> CCGTGGGGTGACCTGAGAA
GGCGCAGCTGAGACTTTAC -> GCGCAGCTGAGACTTTACC
TTATACCCCACTGGGAGCA -> TATACCCCACTGGGAGCAA
ACAGACCCATCGGTCTAAA -> CAGACCCATCGGTCTAAAA
TCAGAGGCTGTCCGCTTGA -> CAGAGGCTGTCCGCTTGAC
GCTTGACCCTCACGCAGGT -> CTTGACCCTCACGCAGGTA
GATTTCATGCGAGATAGAG -> ATTTCATGCGAGATAGAGA
TCTAAAAATACATATATGA -> CTAAAAATACATATATGAA
CCGCTTGACCCTCACGCAG -> CGCTTGACCCTCACGCAGG
CCTCCATGAGACTTGGCGG -> CTCCATGAGACTTGGCGGC
CTATACCTCTGTTATTTTA -> TATACCTCTGTTATTTTAT
AAGAAGATGTGCTCGAGAT -> AGAAGATGTGCTCGAGATC
GACTTTACCGTGTAGGAGC -> ACTTTACCGTGTAGGAGCC
GGGTTCTCGGCTTGTCACA -> GGTTCTCGGCTTGTCACAA
CGTTCCCGTGGTGACTCCG -> GTTCCCGTGGTGACTCCGC
GTACAAGATTCATTTTGCC -> TACAAGATTCATTTTGCCG
AATCCTCTGTCATCGATCT -> ATCCTCTGTCATCGATCTT
TCTATAGTGTGCGCATTGG -> CTATAGTGTGCGCATTGGA
TACAGCCACCCAAAGCCTT -> ACAGCCACCCAAAGCCTTG
GATCGTGCAGAGTCGGAAA -> ATCGTGCAGAGTCGGAAAG
GAGAGGAGGGGCGATCTAT -> AGAGGAGGGGCGATCTATA
GTACGGCCGCCGTCACTCT -> TACGGCCGCCGTCACTCTA
CGTTGGAGTTATTGGGCTG -> GTTGGAGTTATTGGGCTGG
GCACGTGCCTGATGATTTC -> CACGTGCCTGATGATTTCA
TGGAGGACATATTAAAAAA -> GGAGGACATATTAAAAAAC
GATAAGTTACAACCGCCGT -> ATAAGTTACAACCGCCGTC
GAGACTTGGCGGCGATGGT -> AGACTTGGCGGCGATGGTC
GTGAATGGCTGTAGCGTGG -> TGAATGGCTGTAGCGTGGT
ACAGCTCTGCGATACATTC -> CAGCTCTGCGATACATTCC
CCGTTTCTAACAAAAGCCT -> CGTTTCTAACAAAAGCCTA
GGGAATCTCATGATTAATT -> GGAATCTCATGATTAATTT
ATTACGCCGGGCCCATCGA -> TTACGCCGGGCCCATCGAA
TGGAGTGTATTTTCCGTGT -> GGAGTGTATTTTCCGTGTG
GTGCAGCGCCGGTAAGGCC -> TGCAGCGCCGGTAAGGCCG
ATGCAGGTGAAGGCGTACT -> TGCAGGTGAAGGCGTACTT
CGCTACCACTGGGCACGAG -> GCTACCACTGGGCACGAGT
GTCACAATGTTCGTAATAC -> TCACAATGTTCGTAATACA
TTTTGGCGGTGCTCCCGGT -> TTTGGCGGTGCTCCCGGTA
ATGGCTCGGCCGGCGAATG -> TGGCTCGGCCGGCGAATGT
TACCGTGTAGGAGCCCATC -> ACCGTGTAGGAGCCCATCC
TCATGCGAGATAGAGAACA -> CATGCGAGATAGAGAACAG
CTCGGTTGCGCCTTAATAG -> TCGGTTGCGCCTTAATAGC
AGGACATATTAAAAAACTA -> GGACATATTAAAAAACTAA
AGAAGACCTCTTTCGGGAT -> GAAGACCTCTTTCGGGATT
TTATGAAGGCTCTTTCTTT -> TATGAAGGCTCTTTCTTTT
GTCTGGTGAATGGCTGTAG -> TCTGGTGAATGGCTGTAGC
AAGGCAACTCCGTCGAAGT -> AGGCAACTCCGTCGAAGTA
AATTAAAACATAGTCTTTT -> ATTAAAACATAGTCTTTTG
CAATGTTCGTAATACAGGA -> AATGTTCGTAATACAGGAA
TTTCGTCGATTTATGAATC -> TTCGTCGATTTATGAATCC
GGTGACCTGAGAATACAGA -> GTGACCTGAGAATACAGAT
TAATACAGGAACTTCAGAG -> AATACAGGAACTTCAGAGG
AGGCAACTCCGTCGAAGTA -> GGCAACTCCGTCGAAGTAG
TAGTGCCAGGTGTTACTCG -> AGTGCCAGGTGTTACTCGC
CCGTCACTCTAGGTACGTC -> CGTCACTCTAGGTACGTCC
CTAAAAATACATATATGAA -> TAAAAATACATATATGAAG
AATCGGAGATATACATCCC -> ATCGGAGATATACATCCCT
GGTCTAAAAATACATATAT -> GTCTAAAAATACATATATG
CGGTCACAGAACACAGATC -> GGTCACAGAACACAGATCG
TCGCTAACTAGCTTAGAAT -> CGCTAACTAGCTTAGAATG
ATGGGCGCAGCTGAGACTT -> TGGGCGCAGCTGAGACTTT
CGGTTTCCTTGACGCAGAC -> GGTTTCCTTGACGCAGACC
TGACACCATGCGGGCCGTA -> GACACCATGCGGGCCGTAA
CTGGGTTCTCGGCTTGTCA -> TGGGTTCTCGGCTTGTCAC
TGGTGACTCCGCGGCCCCA -> GGTGACTCCGCGGCCCCAT
GCACGAGTCAGAATCCTCT -> CACGAGTCAGAATCCTCTG
CTCTGCGATACATTCCAAG -> TCTGCGATACATTCCAAGA
TTCCTTGACGCAGACCCAT -> TCCTTGACGCAGACCCATC
TCTGCGATACATTCCAAGA -> CTGCGATACATTCCAAGAT
AGCTGGTATTATGGATGGC -> GCTGGTATTATGGATGGCG
CGTAGAAGCGCATCAATCG -> GTAGAAGCGCATCAATCGT
GCCTTTGGCCTGCATAGAG -> CCTTTGGCCTGCATAGAGC
CCTTTGACCCTAGTCCGTG -> CTTTGACCCTAGTCCGTGG
GATCGTTTCTAAAGACATA -> ATCGTTTCTAAAGACATAT
AATCTTGTGTCCGACTCAA -> ATCTTGTGTCCGACTCAAG
TTTCCCGATAAATCTTTAG -> TTCCCGATAAATCTTTAGT
CGGCCGGCGAATGTCAGAC -> GGCCGGCGAATGTCAGACC
AATTGAGACATCAGCGCTT -> ATTGAGACATCAGCGCTTA
GTCGGAAAGTTGTTAAAGT -> TCGGAAAGTTGTTAAAGTA
GTCTAGAATGATAAGTTAC -> TCTAGAATGATAAGTTACA
ATGGTCAAATTATTGTCAT -> TGGTCAAATTATTGTCATG
TGTCCGCTTGACCCTCACG -> GTCCGCTTGACCCTCACGC
GGTGAATGGCTGTAGCGTG -> GTGAATGGCTGTAGCGTGG
TTATTTTATACCCTTGTCT -> TATTTTATACCCTTGTCTC
GGCACGAGTCAGAATCCTC -> GCACGAGTCAGAATCCTCT
GGTTTGATTTCAAACATGA -> GTTTGATTTCAAACATGAA
GGCCCGCAGATACGATTAG -> GCCCGCAGATACGATTAGT
TTAACGTAGCATGCAGGTG -> TAACGTAGCATGCAGGTGA
AACTAGCTTAGAATGGCAC -> ACTAGCTTAGAATGGCACT
CTCGAGATCGTTTCTAAAG -> TCGAGATCGTTTCTAAAGA
AATGTTCGTAATACAGGAA -> ATGTTCGTAATACAGGAAC
TGACCCTCGGTTGCGCCTT -> GACCCTCGGTTGCGCCTTA
TATTAAAAAACTAAATATC -> ATTAAAAAACTAAATATCG
CCGACTCAAGGAGAAGGCA -> CGACTCAAGGAGAAGGCAA
AGGTCCGAGCCACTGGTGT -> GGTCCGAGCCACTGGTGTA
CAACACACAGACCCATCGG -> AACACACAGACCCATCGGT
GATCCGGATACCGTGTTCA -> ATCCGGATACCGTGTTCAT
CTAACAAAAGCCTATACGA -> TAACAAAAGCCTATACGAG
TTAAAACATAGTCTTTTGA -> TAAAACATAGTCTTTTGAC
TATGAATCCGGGCCGCCTG -> ATGAATCCGGGCCGCCTGG
AGACTTGGCGGCGATGGTC -> GACTTGGCGGCGATGGTCA
CCCGGTACGCCCCCATCGC -> CCGGTACGCCCCCATCGCG
TGGCCTGCATAGAGCTGGT -> GGCCTGCATAGAGCTGGTA
TGAAATCTCTATCGTGGTC -> GAAATCTCTATCGTGGTCC
CTCGCCATTGAAGTCTGGT -> TCGCCATTGAAGTCTGGTG
GGGAGCAACGATTGCCGTA -> GGAGCAACGATTGCCGTAG
TAAATATCGGAGAAGCGGT -> AAATATCGGAGAAGCGGTC
TTCCCGATAAATCTTTAGT -> TCCCGATAAATCTTTAGTT
ATCGTTTCTAAAGACATAT -> TCGTTTCTAAAGACATATC
AGCGAATCGCGAGAGGAGG -> GCGAATCGCGAGAGGAGGG
ATACCAGGCCCGCAGATAC -> TACCAGGCCCGCAGATACG
AAGACATATCCAATGATAG -> AGACATATCCAATGATAGC
GAGCAACGATTGCCGTAGT -> AGCAACGATTGCCGTAGTA
GCATCAGCAGAAGGCACGT -> CATCAGCAGAAGGCACGTG
GAGAATCCGCTACCACTGG -> AGAATCCGCTACCACTGGG
AGTGTGCGCATTGGACGCG -> GTGTGCGCATTGGACGCGT
GCTAACTAGCTTAGAATGG -> CTAACTAGCTTAGAATGGC
ACAGAGAATCCGCTACCAC -> CAGAGAATCCGCTACCACT
TGAAGAAGATGTGCTCGAG -> GAAGAAGATGTGCTCGAGA
CCTCGCTAACTAGCTTAGA -> CTCGCTAACTAGCTTAGAA
CCTAGTCGGGTGGAGTGTA -> CTAGTCGGGTGGAGTGTAT
CGCAGGTACAAGATTCATT -> GCAGGTACAAGATTCATTT
GACTTGGCGGCGATGGTCA -> ACTTGGCGGCGATGGTCAA
TCCGCGGCCCCATCCCCGC -> CCGCGGCCCCATCCCCGCT
CTTAGTCGCTCGGCGCGCT -> TTAGTCGCTCGGCGCGCTG
TGGCGTGCAGCGCCGGTAA -> GGCGTGCAGCGCCGGTAAG
GACATCAGCGCTTAAAAAT -> ACATCAGCGCTTAAAAATC
GGCCGGCGAATGTCAGACC -> GCCGGCGAATGTCAGACCC
ACCGGTTAGATGCCCACCA -> CCGGTTAGATGCCCACCAA
ATTAAAACATAGTCTTTTG -> TTAAAACATAGTCTTTTGA
CGACCATGTCAGACCCATC -> GACCATGTCAGACCCATCG
TTAGTTTCGCGAAGGACCC -> TAGTTTCGCGAAGGACCCA
TCCGTCGAAGTAGTGCCAG -> CCGTCGAAGTAGTGCCAGG
AGCCCATCCAGAAGTCGCC -> GCCCATCCAGAAGTCGCCA
GTAGTCTAGAATGATAAGT -> TAGTCTAGAATGATAAGTT
TCCGGGCCGCCTGGTAACA -> CCGGGCCGCCTGGTAACAT
GAGACTTTACCGTGTAGGA -> AGACTTTACCGTGTAGGAG
AGGACCCATCGGTATCTGA -> GGACCCATCGGTATCTGAT
AACTAAATATCGGAGAAGC -> ACTAAATATCGGAGAAGCG
AGCTGTACATACACATTAC -> GCTGTACATACACATTACG
GATGTTTTAAGTCAGTAGC -> ATGTTTTAAGTCAGTAGCG
GGACATATTAAAAAACTAA -> GACATATTAAAAAACTAAA
TTACCGTGTAGGAGCCCAT -> TACCGTGTAGGAGCCCATC
ATGTCAGACCCATCGGTCT -> TGTCAGACCCATCGGTCTA,TGTCAGACCCATCGGTCTA
AGTAACCTTAGTCGCTCGG -> GTAACCTTAGTCGCTCGGC
TCACAGAACACAGATCGCG -> CACAGAACACAGATCGCGT
TCGCTCGGCGCGCTGTCAT -> CGCTCGGCGCGCTGTCATG
ACTCCTAATGTTAAGGAGC -> CTCCTAATGTTAAGGAGCG
CACACAGGTAGTCTAGAAT -> ACACAGGTAGTCTAGAATG
GGATGTTTTAAGTCAGTAG -> GATGTTTTAAGTCAGTAGC
CGTACTTAACGTTCCCGTG -> GTACTTAACGTTCCCGTGG
CGGTCTAAAAGGCCGACCA -> GGTCTAAAAGGCCGACCAT
AGGCCCGCAGATACGATTA -> GGCCCGCAGATACGATTAG
CCATCGGTCTAAAAGGCCG -> CATCGGTCTAAAAGGCCGA
ACGAGGTACGGCCGCCGTC -> CGAGGTACGGCCGCCGTCA
GGCTCTTTCTTTTCGCGTA -> GCTCTTTCTTTTCGCGTAG
TGATGGCTCGGTTTCCTTG -> GATGGCTCGGTTTCCTTGA
CTCTAGGTACGTCCCTAGT -> TCTAGGTACGTCCCTAGTG
GAAGTCTGGTGAATGGCTG -> AAGTCTGGTGAATGGCTGT
TTGACGCAGACCCATCGGT -> TGACGCAGACCCATCGGTC
TGACCCTCACGCAGGTACA -> GACCCTCACGCAGGTACAA
ATACCCCACTGGGAGCAAC -> TACCCCACTGGGAGCAACG
TTTCTTTTCGCGTAGAAGC -> TTCTTTTCGCGTAGAAGCG
ACCCACCGTTTCTAACAAA -> CCCACCGTTTCTAACAAAA
ACTTCTCCACGATCCGGAT -> CTTCTCCACGATCCGGATA
GCCTGGTAACATTACTACA -> CCTGGTAACATTACTACAC
AGTCCGTGGGGTGACCTGA -> GTCCGTGGGGTGACCTGAG
TCACTCTAGGTACGTCCCT -> CACTCTAGGTACGTCCCTA
GAGGATGTTTTAAGTCAGT -> AGGATGTTTTAAGTCAGTA
CTATGGCTGGCGTGCAGCG -> TATGGCTGGCGTGCAGCGC
CCCCATCGCGGTCTTGATG -> CCCATCGCGGTCTTGATGG
CCGGTACGCCCCCATCGCG -> CGGTACGCCCCCATCGCGG
CGATGGTCAAATTATTGTC -> GATGGTCAAATTATTGTCA
TTGACCCTAGTCCGTGGGG -> TGACCCTAGTCCGTGGGGT
GATGGCTCGGCCGGCGAAT -> ATGGCTCGGCCGGCGAATG
CCCATCCAGAAGTCGCCAC -> CCATCCAGAAGTCGCCACC
TGAGAATACAGATCGTGCA -> GAGAATACAGATCGTGCAG
GACGGCGCAAAGCCGATAA -> ACGGCGCAAAGCCGATAAT
AGATCGCGTTCCATAAACC -> GATCGCGTTCCATAAACCG
TTACGCCGGGCCCATCGAA -> TACGCCGGGCCCATCGAAA
CCCATCCCCGCTGGTAGTA -> CCATCCCCGCTGGTAGTAA
TCTTTATCATGACCCTCGG -> CTTTATCATGACCCTCGGT
ATCCGGGCCGCCTGGTAAC -> TCCGGGCCGCCTGGTAACA
TTGATTTCAAACATGAATC -> TGATTTCAAACATGAATCA
GTAGTGCCAGGTGTTACTC -> TAGTGCCAGGTGTTACTCG
GCTCTTTCTTTTCGCGTAG -> CTCTTTCTTTTCGCGTAGA
AAATCTTGTGTCCGACTCA -> AATCTTGTGTCCGACTCAA
CGGCGAATGTCAGACCCAT -> GGCGAATGTCAGACCCATC
TGTTCGTAATACAGGAACT -> GTTCGTAATACAGGAACTT
GCGAGATAGAGAACAGCTC -> CGAGATAGAGAACAGCTCT
AGGCACGTGCCTGATGATT -> GGCACGTGCCTGATGATTT
GTGGAGTGTATTTTCCGTG -> TGGAGTGTATTTTCCGTGT
GCGCAGCTGAGACTTTACC -> CGCAGCTGAGACTTTACCG
TTTATGAATCCGGGCCGCC -> TTATGAATCCGGGCCGCCT
ATTTTCCGTGTGACACCAT -> TTTTCCGTGTGACACCATG
AGTTGGCTTTAACGTAGCA -> GTTGGCTTTAACGTAGCAT
ATCCCTCGTTGGGAATCTC -> TCCCTCGTTGGGAATCTCA
CCTTGACGCAGACCCATCG -> CTTGACGCAGACCCATCGG
TGAGACTTTACCGTGTAGG -> GAGACTTTACCGTGTAGGA
CCTCCGTGCGTACACCCGA -> CTCCGTGCGTACACCCGAG
CTTGATACCGAAGGTTAAA -> TTGATACCGAAGGTTAAAG
CTGGTAGTAACCTTAGTCG -> TGGTAGTAACCTTAGTCGC
GACCCTAGTCCGTGGGGTG -> ACCCTAGTCCGTGGGGTGA
ATGAAGGGCTAAGCTACAT -> TGAAGGGCTAAGCTACATC
AGTAGCGCTTATCACACAG -> GTAGCGCTTATCACACAGA
GTTGGCTTTAACGTAGCAT -> TTGGCTTTAACGTAGCATG
CGACTCAAGGAGAAGGCAA -> GACTCAAGGAGAAGGCAAC
TTGGGCTGGGTTCTCGGCT -> TGGGCTGGGTTCTCGGCTT
CTAGAATGATAAGTTACAA -> TAGAATGATAAGTTACAAC
TACCACTGGGCACGAGTCA -> ACCACTGGGCACGAGTCAG
GCGCAAAGCCGATAATCGG -> CGCAAAGCCGATAATCGGA
TGTACATACACATTACGCC -> GTACATACACATTACGCCG
CCACCCTTTGACCCTAGTC -> CACCCTTTGACCCTAGTCC
TGGGCACGAGTCAGAATCC -> GGGCACGAGTCAGAATCCT
CAGTATGCGGAGTATATTA -> AGTATGCGGAGTATATTAT
TAGTCCGTGGGGTGACCTG -> AGTCCGTGGGGTGACCTGA
GGATTTCGTCGATTTATGA -> GATTTCGTCGATTTATGAA
TTAGGACTGAAATGGGCGC -> TAGGACTGAAATGGGCGCA
TACATTCCAAGATCTCTTA -> ACATTCCAAGATCTCTTAG
CCAATTAAAACATAGTCTT -> CAATTAAAACATAGTCTTT
TCCGTGCGTACACCCGAGC -> CCGTGCGTACACCCGAGCT
GGGCCCATCGAAATGGGGA -> GGCCCATCGAAATGGGGAG
AAGGCACGTGCCTGATGAT -> AGGCACGTGCCTGATGATT
GGTTAGATGCCCACCAATT -> GTTAGATGCCCACCAATTA
AAGCCTATACGAGGCATCA -> AGCCTATACGAGGCATCAG
GTTACTCGCCATTGAAGTC -> TTACTCGCCATTGAAGTCT
TATGGCTGGCGTGCAGCGC -> ATGGCTGGCGTGCAGCGCC
GCAACGATTGCCGTAGTAA -> CAACGATTGCCGTAGTAAC
AGCGAGAAGCAGTATGCGG -> GCGAGAAGCAGTATGCGGA
GATTGCAACACACAGACCC -> ATTGCAACACACAGACCCA
GTTGGAGTTATTGGGCTGG -> TTGGAGTTATTGGGCTGGG
CAGGTGTTACTCGCCATTG -> AGGTGTTACTCGCCATTGA
AGGAGCCCATCCAGAAGTC -> GGAGCCCATCCAGAAGTCG
ATCGCGGTCTTGATGGCTC -> TCGCGGTCTTGATGGCTCG
ATTAGTAGTCTATGCTAGA -> TTAGTAGTCTATGCTAGAA
TTTCGGGATTTCGTCGATT -> TTCGGGATTTCGTCGATTT
CCTTAGTCGCTCGGCGCGC -> CTTAGTCGCTCGGCGCGCT
GAACTGCGGTGGGTTTGAT -> AACTGCGGTGGGTTTGATT
AGTGGTCGGGGCACGAGGG -> GTGGTCGGGGCACGAGGGA
AGTAACTTCTCCACGATCC -> GTAACTTCTCCACGATCCG
ATCGCGTTCCATAAACCGG -> TCGCGTTCCATAAACCGGT
ATGATAGCAGCCTAGTCGG -> TGATAGCAGCCTAGTCGGG
ATATTAGTTTTGGCGGTGC -> TATTAGTTTTGGCGGTGCT
CACCATGCGGGCCGTAAAA -> ACCATGCGGGCCGTAAAAT
GCTCCCCTCCATGAGACTT -> CTCCCCTCCATGAGACTTG
TGAACTGCGGTGGGTTTGA -> GAACTGCGGTGGGTTTGAT
GATTAGTAGTCTATGCTAG -> ATTAGTAGTCTATGCTAGA
ATTGCCGTAGTAACTTCTC -> TTGCCGTAGTAACTTCTCC
TCACACAGAGAATCCGCTA -> CACACAGAGAATCCGCTAC
CCGCCGTCGTTGGAGTTAT -> CGCCGTCGTTGGAGTTATT
ACCTGTGAAATCTCTATCG -> CCTGTGAAATCTCTATCGT
TACACATTACGCCGGGCCC -> ACACATTACGCCGGGCCCA
AGCCGATAATCGGAGATAT -> GCCGATAATCGGAGATATA
TGACAAAACTCCTAATGTT -> GACAAAACTCCTAATGTTA
CCCTTTGACCCTAGTCCGT -> CCTTTGACCCTAGTCCGTG
ACATCCCTCGTTGGGAATC -> CATCCCTCGTTGGGAATCT
AAGTCAGTAGCGCTTATCA -> AGTCAGTAGCGCTTATCAC
CATGGAACGTAGGCGGTCT -> ATGGAACGTAGGCGGTCTT
ATCGAAATGGGGAGGACAG -> TCGAAATGGGGAGGACAGA
CCTAATGTTAAGGAGCGAA -> CTAATGTTAAGGAGCGAAT
CCACTGGTGTATTATATTG -> CACTGGTGTATTATATTGA
GGGCGCAGCTGAGACTTTA -> GGCGCAGCTGAGACTTTAC
ACCGTTTCTAACAAAAGCC -> CCGTTTCTAACAAAAGCCT
TGCCGTGCTATGGCTGGCG -> GCCGTGCTATGGCTGGCGT
AAAACATAGTCTTTTGACG -> AAACATAGTCTTTTGACGG
CTTTTGACGGCGCAAAGCC -> TTTTGACGGCGCAAAGCCG
CACTGGGAGCAACGATTGC -> ACTGGGAGCAACGATTGCC
GAGCTAGCCACTAGTCCTG -> AGCTAGCCACTAGTCCTGA
CGCGAGAGGAGGGGCGATC -> GCGAGAGGAGGGGCGATCT
ATCGGTCTAAAAGTTGGCT -> TCGGTCTAAAAGTTGGCTT
GTCGAAGTAGTGCCAGGTG -> TCGAAGTAGTGCCAGGTGT
TAGGTACGTCCCTAGTGGT -> AGGTACGTCCCTAGTGGTC
GCTTAAAAATCTTGTGTCC -> CTTAAAAATCTTGTGTCCG
AATCTCATGATTAATTTCG -> ATCTCATGATTAATTTCGT
GTATTATGGATGGCGGCCG -> TATTATGGATGGCGGCCGC
CATCTGGTCCATTCAAGCT -> ATCTGGTCCATTCAAGCTC
TGGCTCGGCCGGCGAATGT -> GGCTCGGCCGGCGAATGTC
ATTAGTTTTGGCGGTGCTC -> TTAGTTTTGGCGGTGCTCC
CCCGCAGATACGATTAGTA -> CCGCAGATACGATTAGTAG
TATGCTAGAATGGTAAGAG -> ATGCTAGAATGGTAAGAGT
TGCGGGCCGTAAAATGGTA -> GCGGGCCGTAAAATGGTAC
TACGAGGCATCAGCAGAAG -> ACGAGGCATCAGCAGAAGG
CATGACCCTCGGTTGCGCC -> ATGACCCTCGGTTGCGCCT
ATGTTTTAAGTCAGTAGCG -> TGTTTTAAGTCAGTAGCGC
CTGCGATACATTCCAAGAT -> TGCGATACATTCCAAGATC
GAATACAGATCGTGCAGAG -> AATACAGATCGTGCAGAGT
GTTATTTTATACCCTTGTC -> TTATTTTATACCCTTGTCT
TTTTCGCGTAGAAGCGCAT -> TTTCGCGTAGAAGCGCATC
CATACACATTACGCCGGGC -> ATACACATTACGCCGGGCC
GGTAAGAGTTAGGACTGAA -> GTAAGAGTTAGGACTGAAA
ACGGCCGCCGTCACTCTAG -> CGGCCGCCGTCACTCTAGG
GTGTTACTCGCCATTGAAG -> TGTTACTCGCCATTGAAGT
ATTCCAAGATCTCTTAGTT -> TTCCAAGATCTCTTAGTTA
TGTCAGACCCATCGGTCTA -> GTCAGACCCATCGGTCTAA,GTCAGACCCATCGGTCTAA
TCTATGCTAGAATGGTAAG -> CTATGCTAGAATGGTAAGA
CTGCATAGAGCTGGTATTA -> TGCATAGAGCTGGTATTAT
CGCCAGCGAGAAGCAGTAT -> GCCAGCGAGAAGCAGTATG
CGCATCAATCGTCCACCGA -> GCATCAATCGTCCACCGAG
GGCGATCTATAGTGTGCGC -> GCGATCTATAGTGTGCGCA
TTCCCGTGGTGACTCCGCG -> TCCCGTGGTGACTCCGCGG
TCGTTGGGAATCTCATGAT -> CGTTGGGAATCTCATGATT
AACCGCCGTCGTTGGAGTT -> ACCGCCGTCGTTGGAGTTA
AAAGTTTCCCGATAAATCT -> AAGTTTCCCGATAAATCTT
GATATACATCCCTCGTTGG -> ATATACATCCCTCGTTGGG
GTTCCATAAACCGGTTAGA -> TTCCATAAACCGGTTAGAT
ATGGTAAGAGTTAGGACTG -> TGGTAAGAGTTAGGACTGA
TAATGTTAAGGAGCGAATC -> AATGTTAAGGAGCGAATCG
TTCTAAAGACATATCCAAT -> TCTAAAGACATATCCAATG
GGCGCGCTGTCATGAGGAT -> GCGCGCTGTCATGAGGATG
AGGAGAAGGCAACTCCGTC -> GGAGAAGGCAACTCCGTCG
TATGAAGGGCTAAGCTACA -> ATGAAGGGCTAAGCTACAT
GCACGAGGGAGCTAGCCAC -> CACGAGGGAGCTAGCCACT
GTGACCTGAGAATACAGAT -> TGACCTGAGAATACAGATC
CATATCCAATGATAGCAGC -> ATATCCAATGATAGCAGCC
TGGTCGGGGCACGAGGGAG -> GGTCGGGGCACGAGGGAGC
ACGATTAGTAGTCTATGCT -> CGATTAGTAGTCTATGCTA
AATACATATATGAAGGGCT -> ATACATATATGAAGGGCTA
TGACCCTAGTCCGTGGGGT -> GACCCTAGTCCGTGGGGTG
CCAGGCCCGCAGATACGAT -> CAGGCCCGCAGATACGATT
TTGAGACATCAGCGCTTAA -> TGAGACATCAGCGCTTAAA
TAGCTGTACATACACATTA -> AGCTGTACATACACATTAC
ATACACATTACGCCGGGCC -> TACACATTACGCCGGGCCC
TGATTATACCCCACTGGGA -> GATTATACCCCACTGGGAG
AACACAGATCGCGTTCCAT -> ACACAGATCGCGTTCCATA
AAAAACTAAATATCGGAGA -> AAAACTAAATATCGGAGAA
TTCTCGGCTTGTCACAATG -> TCTCGGCTTGTCACAATGT
GACTGGTGATTGAACTGCG -> ACTGGTGATTGAACTGCGG
CAGAACACAGATCGCGTTC -> AGAACACAGATCGCGTTCC
TCATGAGGATGTTTTAAGT -> CATGAGGATGTTTTAAGTC
TCTAACAAAAGCCTATACG -> CTAACAAAAGCCTATACGA
ATGCAATGGAGGACATATT -> TGCAATGGAGGACATATTA
GTTGTAATACCAGGCCCGC -> TTGTAATACCAGGCCCGCA
ATATTATGAAGGCTCTTTC -> TATTATGAAGGCTCTTTCT
AAAGCCTATACGAGGCATC -> AAGCCTATACGAGGCATCA
TGGACGCGTTGAGTCTAGC -> GGACGCGTTGAGTCTAGCG
AAAGGCCGACCATGTCAGA -> AAGGCCGACCATGTCAGAC
TGACGCAGACCCATCGGTC -> GACGCAGACCCATCGGTCT
AGATAGAGAACAGCTCTGC -> GATAGAGAACAGCTCTGCG
TTAGAATGGCACTGTATTC -> TAGAATGGCACTGTATTCC
CCGCCAGCGAGAAGCAGTA -> CGCCAGCGAGAAGCAGTAT
TACTCGCCATTGAAGTCTG -> ACTCGCCATTGAAGTCTGG
TCGGAAAGTTGTTAAAGTA -> CGGAAAGTTGTTAAAGTAA
TCATGACCCTCGGTTGCGC -> CATGACCCTCGGTTGCGCC
TGATTTCATGCGAGATAGA -> GATTTCATGCGAGATAGAG
GGTATTATGGATGGCGGCC -> GTATTATGGATGGCGGCCG
GTAAGAGTTAGGACTGAAA -> TAAGAGTTAGGACTGAAAT
GCTGTAGCGTGGTTACGAG -> CTGTAGCGTGGTTACGAGG
CACAGGTAGTCTAGAATGA -> ACAGGTAGTCTAGAATGAT
TACGTCCCTAGTGGTCGGG -> ACGTCCCTAGTGGTCGGGG
TTGTCACAATGTTCGTAAT -> TGTCACAATGTTCGTAATA
TCAAGCTCCCCTCCATGAG -> CAAGCTCCCCTCCATGAGA
CTAGTGGTCGGGGCACGAG -> TAGTGGTCGGGGCACGAGG
ACGCAGACCCATCGGTCTA -> CGCAGACCCATCGGTCTAA
CTACCACTGGGCACGAGTC -> TACCACTGGGCACGAGTCA
GCGGGCCGTAAAATGGTAC -> CGGGCCGTAAAATGGTACT
CTAGGTACGTCCCTAGTGG -> TAGGTACGTCCCTAGTGGT
TCAAGGAGAAGGCAACTCC -> CAAGGAGAAGGCAACTCCG
TGCAGAGTCGGAAAGTTGT -> GCAGAGTCGGAAAGTTGTT
CTATCGTGGTCCCTCGCTA -> TATCGTGGTCCCTCGCTAA
TTTCATGCGAGATAGAGAA -> TTCATGCGAGATAGAGAAC
TCAGCAGAAGGCACGTGCC -> CAGCAGAAGGCACGTGCCT
GGAGGACAGAAGACCTCTT -> GAGGACAGAAGACCTCTTT
GCGCATCAATCGTCCACCG -> CGCATCAATCGTCCACCGA
GGCGTGCAGCGCCGGTAAG -> GCGTGCAGCGCCGGTAAGG
TAGCCACTAGTCCTGAAGA -> AGCCACTAGTCCTGAAGAA
GGGCTGGGTTCTCGGCTTG -> GGCTGGGTTCTCGGCTTGT
GGTTACAAATTGAGACATC -> GTTACAAATTGAGACATCA
CACCGCCAGCGAGAAGCAG -> ACCGCCAGCGAGAAGCAGT
GTGCGGTCTTGATGGCTCG -> TGCGGTCTTGATGGCTCGG
TTCGTAATACAGGAACTTC -> TCGTAATACAGGAACTTCA
TGGTGTATTATATTGACAA -> GGTGTATTATATTGACAAA
AGGACTGAAATGGGCGCAG -> GGACTGAAATGGGCGCAGC
TATACCCTTGTCTCCGCCT -> ATACCCTTGTCTCCGCCTT
TTGATGGCTCGTGCGGTCT -> TGATGGCTCGTGCGGTCTT
TGTTATTTTATACCCTTGT -> GTTATTTTATACCCTTGTC
GTGTCCGACTCAAGGAGAA -> TGTCCGACTCAAGGAGAAG
TATTATATTGACAAAACTC -> ATTATATTGACAAAACTCC
CAAATTGAGACATCAGCGC -> AAATTGAGACATCAGCGCT
CGTACAGCCACCCAAAGCC -> GTACAGCCACCCAAAGCCT
ACTTCAGAGGCTGTCCGCT -> CTTCAGAGGCTGTCCGCTT
CCATCCAGAAGTCGCCACC -> CATCCAGAAGTCGCCACCC
ATCACACAGAGAATCCGCT -> TCACACAGAGAATCCGCTA
ATCCGGATACCGTGTTCAT -> TCCGGATACCGTGTTCATA
AGAGACTGTTGAACGTACA -> GAGACTGTTGAACGTACAG
ATAAACCGGTTAGATGCCC -> TAAACCGGTTAGATGCCCA
ACCATGGAACGTAGGCGGT -> CCATGGAACGTAGGCGGTC
CAGGAACTTCAGAGGCTGT -> AGGAACTTCAGAGGCTGTC
CTAACTAGCTTAGAATGGC -> TAACTAGCTTAGAATGGCA
GATCTATAGTGTGCGCATT -> ATCTATAGTGTGCGCATTG
TTTAAGTCAGTAGCGCTTA -> TTAAGTCAGTAGCGCTTAT
AGTTTCGCGAAGGACCCAT -> GTTTCGCGAAGGACCCATC
AGAGGAGGGGCGATCTATA -> GAGGAGGGGCGATCTATAG
GGTCTAAAAGTTGGCTTTA -> GTCTAAAAGTTGGCTTTAA
TTTGGCGGTGCTCCCGGTA -> TTGGCGGTGCTCCCGGTAC
GCATTGGACGCGTTGAGTC -> CATTGGACGCGTTGAGTCT
GAGTCGGAAAGTTGTTAAA -> AGTCGGAAAGTTGTTAAAG
GCGGTCTTGATGGCTCGGC -> CGGTCTTGATGGCTCGGCC
AGCCACTGGTGTATTATAT -> GCCACTGGTGTATTATATT
GATTGAACTGCGGTGGGTT -> ATTGAACTGCGGTGGGTTT
GATTTATGAATCCGGGCCG -> ATTTATGAATCCGGGCCGC
ATACAGGAACTTCAGAGGC -> TACAGGAACTTCAGAGGCT
TCTGTTATTTTATACCCTT -> CTGTTATTTTATACCCTTG
CTTATCACACAGAGAATCC -> TTATCACACAGAGAATCCG
TCAGAATCCTCTGTCATCG -> CAGAATCCTCTGTCATCGA
CCCGATAAATCTTTAGTTT -> CCGATAAATCTTTAGTTTC
CCACCAATTAAAACATAGT -> CACCAATTAAAACATAGTC
GAGAAGGCAACTCCGTCGA -> AGAAGGCAACTCCGTCGAA
AAATGGGCGCAGCTGAGAC -> AATGGGCGCAGCTGAGACT
GGTGACTCCGCGGCCCCAT -> GTGACTCCGCGGCCCCATC
GTTAGGACTGAAATGGGCG -> TTAGGACTGAAATGGGCGC
AATCCGCTACCACTGGGCA -> ATCCGCTACCACTGGGCAC
CTCGGCTTGTCACAATGTT -> TCGGCTTGTCACAATGTTC
TAAAAATACATATATGAAG -> AAAAATACATATATGAAGG
AGGCATCAGCAGAAGGCAC -> GGCATCAGCAGAAGGCACG
CTGTCATCGATCTTAGCAG -> TGTCATCGATCTTAGCAGG
TGGCAGAGTGTTGTAATAC -> GGCAGAGTGTTGTAATACC
TTCCATCTGGTCCATTCAA -> TCCATCTGGTCCATTCAAG
TACAGATCGTGCAGAGTCG -> ACAGATCGTGCAGAGTCGG
AAATATCGGAGAAGCGGTC -> AATATCGGAGAAGCGGTCT
GTTGTTAAAGTAACTCAAA -> TTGTTAAAGTAACTCAAAA
GAACGTACAGCCACCCAAA -> AACGTACAGCCACCCAAAG
GTCTCCGCCTTTGGCCTGC -> TCTCCGCCTTTGGCCTGCA
GTATTTTCCGTGTGACACC -> TATTTTCCGTGTGACACCA
GTAGCGTGGTTACGAGGTA -> TAGCGTGGTTACGAGGTAC
GTAGTAACTTCTCCACGAT -> TAGTAACTTCTCCACGATC
GGCACGTGCCTGATGATTT -> GCACGTGCCTGATGATTTC
TTTTGCCGTGCTATGGCTG -> TTTGCCGTGCTATGGCTGG
GAGATATACATCCCTCGTT -> AGATATACATCCCTCGTTG
CCGAAGGTTAAAGTTTCCC -> CGAAGGTTAAAGTTTCCCG
TACCTCCGTGCGTACACCC -> ACCTCCGTGCGTACACCCG
TCGGTCTAAAAGTTGGCTT -> CGGTCTAAAAGTTGGCTTT
TCGCGAAGGACCCATCGGT -> CGCGAAGGACCCATCGGTA
CGCGAAGGACCCATCGGTA -> GCGAAGGACCCATCGGTAT
TACCGAAGGTTAAAGTTTC -> ACCGAAGGTTAAAGTTTCC
TAGTTTTGGCGGTGCTCCC -> AGTTTTGGCGGTGCTCCCG
TACATATATGAAGGGCTAA -> ACATATATGAAGGGCTAAG
TTACTCGCCATTGAAGTCT -> TACTCGCCATTGAAGTCTG
GAGATAGAGAACAGCTCTG -> AGATAGAGAACAGCTCTGC
TCTTTCGGGATTTCGTCGA -> CTTTCGGGATTTCGTCGAT
TGGGGTGACCTGAGAATAC -> GGGGTGACCTGAGAATACA
ATACGAGGCATCAGCAGAA -> TACGAGGCATCAGCAGAAG
GAGGAGGGGCGATCTATAG -> AGGAGGGGCGATCTATAGT
CTAGCGTACCTGTGAAATC -> TAGCGTACCTGTGAAATCT
ATGTGCTCGAGATCGTTTC -> TGTGCTCGAGATCGTTTCT
GCAGAAGGCACGTGCCTGA -> CAGAAGGCACGTGCCTGAT
AGAAGCGGTCTTGATGGCT -> GAAGCGGTCTTGATGGCTC
ACCCAAAGCCTTGATACCG -> CCCAAAGCCTTGATACCGA
AGGGGCGATCTATAGTGTG -> GGGGCGATCTATAGTGTGC
AATCGCGAGAGGAGGGGCG -> ATCGCGAGAGGAGGGGCGA
TATACATCCCTCGTTGGGA -> ATACATCCCTCGTTGGGAA
GATTCATTTTGCCGTGCTA -> ATTCATTTTGCCGTGCTAT
ACCGCCGTCGTTGGAGTTA -> CCGCCGTCGTTGGAGTTAT
GTACGCCCCCATCGCGGTC -> TACGCCCCCATCGCGGTCT
TCTCATGATTAATTTCGTT -> CTCATGATTAATTTCGTTC
CAAAGCCGATAATCGGAGA -> AAAGCCGATAATCGGAGAT
GGTTGCGCCTTAATAGCTG -> GTTGCGCCTTAATAGCTGT
GTTCTCGGCTTGTCACAAT -> TTCTCGGCTTGTCACAATG
GTCAGACCCATCGGTCTAA -> TCAGACCCATCGGTCTAAA,TCAGACCCATCGGTCTAAA
GCCGCCGGTCACAGAACAC -> CCGCCGGTCACAGAACACA
GTAGAAGCGCATCAATCGT -> TAGAAGCGCATCAATCGTC
GTAGTCTATGCTAGAATGG -> TAGTCTATGCTAGAATGGT
ACTCAAGGAGAAGGCAACT -> CTCAAGGAGAAGGCAACTC
GGAGCTAGCCACTAGTCCT -> GAGCTAGCCACTAGTCCTG
TGAATGGCTGTAGCGTGGT -> GAATGGCTGTAGCGTGGTT
CGGAGAAGCGGTCTTGATG -> GGAGAAGCGGTCTTGATGG
TTGTCATGCAATGGAGGAC -> TGTCATGCAATGGAGGACA
ACTCAAAATATTAGTTTTG -> CTCAAAATATTAGTTTTGG
GTAAAATGGTACTCGCTCA -> TAAAATGGTACTCGCTCAC
CCGTCGTTGGAGTTATTGG -> CGTCGTTGGAGTTATTGGG
TTCGGGATTTCGTCGATTT -> TCGGGATTTCGTCGATTTA
AGAGAATCCGCTACCACTG -> GAGAATCCGCTACCACTGG
AGCTCCCCTCCATGAGACT -> GCTCCCCTCCATGAGACTT
GATGGCTCGTGCGGTCTTG -> ATGGCTCGTGCGGTCTTGA
TTAGTAGTCTATGCTAGAA -> TAGTAGTCTATGCTAGAAT
AAAAGCCTATACGAGGCAT -> AAAGCCTATACGAGGCATC
GCTCGAGATCGTTTCTAAA -> CTCGAGATCGTTTCTAAAG
CGCAGATACGATTAGTAGT -> GCAGATACGATTAGTAGTC
GGTTACGAGGTACGGCCGC -> GTTACGAGGTACGGCCGCC
CCTTAATAGCTGTACATAC -> CTTAATAGCTGTACATACA
CATAAACCGGTTAGATGCC -> ATAAACCGGTTAGATGCCC
TGGTTACGAGGTACGGCCG -> GGTTACGAGGTACGGCCGC
GTCTAGCGTACCTGTGAAA -> TCTAGCGTACCTGTGAAAT
GTGAAATCTCTATCGTGGT -> TGAAATCTCTATCGTGGTC
AAGGACCCATCGGTATCTG -> AGGACCCATCGGTATCTGA
GGGTGGAGTGTATTTTCCG -> GGTGGAGTGTATTTTCCGT
ATTGCAACACACAGACCCA -> TTGCAACACACAGACCCAT
AGGTACGGCCGCCGTCACT -> GGTACGGCCGCCGTCACTC
TCCTAATGTTAAGGAGCGA -> CCTAATGTTAAGGAGCGAA
TGGCGGCCGCCGGTCACAG -> GGCGGCCGCCGGTCACAGA
CAGAGGCTGTCCGCTTGAC -> AGAGGCTGTCCGCTTGACC
GGCTCGTGCGGTCTTGATG -> GCTCGTGCGGTCTTGATGG
TCGGATTGCAACACACAGA -> CGGATTGCAACACACAGAC
GACCCATCGGTCTAAAAGT -> ACCCATCGGTCTAAAAGTT
AATATCGGAGAAGCGGTCT -> ATATCGGAGAAGCGGTCTT
ACGAGGGAGCTAGCCACTA -> CGAGGGAGCTAGCCACTAG
TCGGTATCTGATTATACCC -> CGGTATCTGATTATACCCC
CCTCGTTGGGAATCTCATG -> CTCGTTGGGAATCTCATGA
GAAGTCGCCACCCTTTGAC -> AAGTCGCCACCCTTTGACC
ATAGCTGTACATACACATT -> TAGCTGTACATACACATTA
CGCGTAGAAGCGCATCAAT -> GCGTAGAAGCGCATCAATC
GAAGGCTCTTTCTTTTCGC -> AAGGCTCTTTCTTTTCGCG
TTTTGACGGCGCAAAGCCG -> TTTGACGGCGCAAAGCCGA
CAGAAGGCACGTGCCTGAT -> AGAAGGCACGTGCCTGATG
GGGCACGAGTCAGAATCCT -> GGCACGAGTCAGAATCCTC
CTCTTTCTTTTCGCGTAGA -> TCTTTCTTTTCGCGTAGAA
ATGATTAATTTCGTTCTTA -> TGATTAATTTCGTTCTTAG
AAAACTCCTAATGTTAAGG -> AAACTCCTAATGTTAAGGA
GCCGGGCCCATCGAAATGG -> CCGGGCCCATCGAAATGGG
ACATCAGCGCTTAAAAATC -> CATCAGCGCTTAAAAATCT
TGGTATTATGGATGGCGGC -> GGTATTATGGATGGCGGCC
ATCGATCTTAGCAGGTCCG -> TCGATCTTAGCAGGTCCGA
GAAGTAGTGCCAGGTGTTA -> AAGTAGTGCCAGGTGTTAC
TAGCGCTTATCACACAGAG -> AGCGCTTATCACACAGAGA
CGGTTGCGCCTTAATAGCT -> GGTTGCGCCTTAATAGCTG
GGTCGGGGCACGAGGGAGC -> GTCGGGGCACGAGGGAGCT
GCGTACTTAACGTTCCCGT -> CGTACTTAACGTTCCCGTG
GAGTGTATTTTCCGTGTGA -> AGTGTATTTTCCGTGTGAC
TGGCGGCGATGGTCAAATT -> GGCGGCGATGGTCAAATTA
CGGCGCGCTGTCATGAGGA -> GGCGCGCTGTCATGAGGAT
AAGGCTCTTTCTTTTCGCG -> AGGCTCTTTCTTTTCGCGT
CGTGGGGTGACCTGAGAAT -> GTGGGGTGACCTGAGAATA
GTAGGCGGTCTTGATGGCT -> TAGGCGGTCTTGATGGCTC
TTCGTTCTTAGACTGGTGA -> TCGTTCTTAGACTGGTGAT
CTCGCTAACTAGCTTAGAA -> TCGCTAACTAGCTTAGAAT
AAACTAAATATCGGAGAAG -> AACTAAATATCGGAGAAGC
GTTGAGTCTAGCGTACCTG -> TTGAGTCTAGCGTACCTGT
TCGTAATACAGGAACTTCA -> CGTAATACAGGAACTTCAG
ACACAGATCGCGTTCCATA -> CACAGATCGCGTTCCATAA
TAGAGAACAGCTCTGCGAT -> AGAGAACAGCTCTGCGATA
CTGGTATTATGGATGGCGG -> TGGTATTATGGATGGCGGC
GTCCGTGGGGTGACCTGAG -> TCCGTGGGGTGACCTGAGA
TAAGGCCGTTCACCCACCG -> AAGGCCGTTCACCCACCGT
TCTTAGCAGGTCCGAGCCA -> CTTAGCAGGTCCGAGCCAC
CCACTGGGCACGAGTCAGA -> CACTGGGCACGAGTCAGAA
GCGAGAGGAGGGGCGATCT -> CGAGAGGAGGGGCGATCTA
CGTGTAGGAGCCCATCCAG -> GTGTAGGAGCCCATCCAGA
GCTGGTATTATGGATGGCG -> CTGGTATTATGGATGGCGG
GCGTGGTTACGAGGTACGG -> CGTGGTTACGAGGTACGGC
CTGGTGAATGGCTGTAGCG -> TGGTGAATGGCTGTAGCGT
TAGTGTGCGCATTGGACGC -> AGTGTGCGCATTGGACGCG
ACGTACAGCCACCCAAAGC -> CGTACAGCCACCCAAAGCC
CTCTATCGTGGTCCCTCGC -> TCTATCGTGGTCCCTCGCT
CCAAGATCTCTTAGTTACC -> CAAGATCTCTTAGTTACCT
GAGGTACGGCCGCCGTCAC -> AGGTACGGCCGCCGTCACT
TATATTGACAAAACTCCTA -> ATATTGACAAAACTCCTAA
TCACGCAGGTACAAGATTC -> CACGCAGGTACAAGATTCA
TACACCCGAGCTTGGTTAC -> ACACCCGAGCTTGGTTACA
GAACAGCTCTGCGATACAT -> AACAGCTCTGCGATACATT
TACAGGAACTTCAGAGGCT -> ACAGGAACTTCAGAGGCTG
CGAATGTCAGACCCATCGG -> GAATGTCAGACCCATCGGT
AGCGTACCTGTGAAATCTC -> GCGTACCTGTGAAATCTCT
ACCTGAGAATACAGATCGT -> CCTGAGAATACAGATCGTG
CATCCCTCGTTGGGAATCT -> ATCCCTCGTTGGGAATCTC
TATATGAAGGGCTAAGCTA -> ATATGAAGGGCTAAGCTAC
CAAGATCTCTTAGTTACCT -> AAGATCTCTTAGTTACCTC
GGAGCAACGATTGCCGTAG -> GAGCAACGATTGCCGTAGT
CCGTGCGTACACCCGAGCT -> CGTGCGTACACCCGAGCTT
GCTCCCGGTACGCCCCCAT -> CTCCCGGTACGCCCCCATC
GACGCGTTGAGTCTAGCGT -> ACGCGTTGAGTCTAGCGTA
TAGTCTAGAATGATAAGTT -> AGTCTAGAATGATAAGTTA
GTTTCTAAAGACATATCCA -> TTTCTAAAGACATATCCAA
TAGCATGCAGGTGAAGGCG -> AGCATGCAGGTGAAGGCGT
GTCTTGATGGCTCGGCCGG -> TCTTGATGGCTCGGCCGGC
AAAATGGTACTCGCTCACC -> AAATGGTACTCGCTCACCG
TCACCGCCAGCGAGAAGCA -> CACCGCCAGCGAGAAGCAG
TTGATACCGAAGGTTAAAG -> TGATACCGAAGGTTAAAGT
GTATATTATGAAGGCTCTT -> TATATTATGAAGGCTCTTT
TGCCCACCAATTAAAACAT -> GCCCACCAATTAAAACATA
CACGATCCGGATACCGTGT -> ACGATCCGGATACCGTGTT
AAACATAGTCTTTTGACGG -> AACATAGTCTTTTGACGGC
GATTTCGTCGATTTATGAA -> ATTTCGTCGATTTATGAAT
ACGGCGCAAAGCCGATAAT -> CGGCGCAAAGCCGATAATC
AGAAGTCGCCACCCTTTGA -> GAAGTCGCCACCCTTTGAC
CCGTCGAAGTAGTGCCAGG -> CGTCGAAGTAGTGCCAGGT
TTTACCGTGTAGGAGCCCA -> TTACCGTGTAGGAGCCCAT
ATCGGTATCTGATTATACC -> TCGGTATCTGATTATACCC
AAGCAGTATGCGGAGTATA -> AGCAGTATGCGGAGTATAT
CATCGCGGTCTTGATGGCT -> ATCGCGGTCTTGATGGCTC
TGGCTCGGATTGCAACACA -> GGCTCGGATTGCAACACAC
CCTTGTCTCCGCCTTTGGC -> CTTGTCTCCGCCTTTGGCC
TGGAGTTATTGGGCTGGGT -> GGAGTTATTGGGCTGGGTT
CTAATGTTAAGGAGCGAAT -> TAATGTTAAGGAGCGAATC
GTAAGGCCGTTCACCCACC -> TAAGGCCGTTCACCCACCG
TCTTGTGTCCGACTCAAGG -> CTTGTGTCCGACTCAAGGA
CACTGGGCACGAGTCAGAA -> ACTGGGCACGAGTCAGAAT
TTTCTAACAAAAGCCTATA -> TTCTAACAAAAGCCTATAC
ATGGAGGACATATTAAAAA -> TGGAGGACATATTAAAAAA
TATACCCCACTGGGAGCAA -> ATACCCCACTGGGAGCAAC
AGATATACATCCCTCGTTG -> GATATACATCCCTCGTTGG
TTGATGGCTCGGTTTCCTT -> TGATGGCTCGGTTTCCTTG
GGCAACTCCGTCGAAGTAG -> GCAACTCCGTCGAAGTAGT
CATCTTTATCATGACCCTC -> ATCTTTATCATGACCCTCG
CGGCGATGGTCAAATTATT -> GGCGATGGTCAAATTATTG
TAGTTACCTCCGTGCGTAC -> AGTTACCTCCGTGCGTACA
TCTTGATGGCTCGGTTTCC -> CTTGATGGCTCGGTTTCCT
AAATCTCTATCGTGGTCCC -> AATCTCTATCGTGGTCCCT
TAGGACTGAAATGGGCGCA -> AGGACTGAAATGGGCGCAG
GGAGCGAATCGCGAGAGGA -> GAGCGAATCGCGAGAGGAG
CGGAGATATACATCCCTCG -> GGAGATATACATCCCTCGT
GAGTGTTGTAATACCAGGC -> AGTGTTGTAATACCAGGCC
GTGACTCCGCGGCCCCATC -> TGACTCCGCGGCCCCATCC
GTCGATTTATGAATCCGGG -> TCGATTTATGAATCCGGGC
TCCCGATAAATCTTTAGTT -> CCCGATAAATCTTTAGTTT
TGATTTCAAACATGAATCA -> GATTTCAAACATGAATCAA
GCGGTGGGTTTGATTTCAA -> CGGTGGGTTTGATTTCAAA
AGACATCAGCGCTTAAAAA -> GACATCAGCGCTTAAAAAT
CTGCGGTGGGTTTGATTTC -> TGCGGTGGGTTTGATTTCA
AAGTTGTTAAAGTAACTCA -> AGTTGTTAAAGTAACTCAA
GACATATTAAAAAACTAAA -> ACATATTAAAAAACTAAAT
GTGGTCCCTCGCTAACTAG -> TGGTCCCTCGCTAACTAGC
GAGCCCATCCAGAAGTCGC -> AGCCCATCCAGAAGTCGCC
CCCTCGCTAACTAGCTTAG -> CCTCGCTAACTAGCTTAGA
ATACCTCTGTTATTTTATA -> TACCTCTGTTATTTTATAC
AGATGCCCACCAATTAAAA -> GATGCCCACCAATTAAAAC
ACTTGGCGGCGATGGTCAA -> CTTGGCGGCGATGGTCAAA
ATCGGTCTAAAAATACATA -> TCGGTCTAAAAATACATAT
ACTAAATATCGGAGAAGCG -> CTAAATATCGGAGAAGCGG
GCTGGGTTCTCGGCTTGTC -> CTGGGTTCTCGGCTTGTCA
TGTCATCGATCTTAGCAGG -> GTCATCGATCTTAGCAGGT
CCTCTTTCGGGATTTCGTC -> CTCTTTCGGGATTTCGTCG
TATTGTCATGCAATGGAGG -> ATTGTCATGCAATGGAGGA
TCGTTGGAGTTATTGGGCT -> CGTTGGAGTTATTGGGCTG
GCTCGGTTTCCTTGACGCA -> CTCGGTTTCCTTGACGCAG
TGTTCATATCTGGCAGAGT -> GTTCATATCTGGCAGAGTG
AAAGTACCATGGAACGTAG -> AAGTACCATGGAACGTAGG
TGGTTACAAATTGAGACAT -> GGTTACAAATTGAGACATC
AGCGGTCTTGATGGCTCGG -> GCGGTCTTGATGGCTCGGA
GACCCATCGGTATCTGATT -> ACCCATCGGTATCTGATTA
CCGGTAAGGCCGTTCACCC -> CGGTAAGGCCGTTCACCCA
ATCTGGCAGAGTGTTGTAA -> TCTGGCAGAGTGTTGTAAT
TCCCTCGCTAACTAGCTTA -> CCCTCGCTAACTAGCTTAG
TTGAACGTACAGCCACCCA -> TGAACGTACAGCCACCCAA
TAACGTAGCATGCAGGTGA -> AACGTAGCATGCAGGTGAA
CCACTGGGAGCAACGATTG -> CACTGGGAGCAACGATTGC
CGGAGTATATTATGAAGGC -> GGAGTATATTATGAAGGCT
AACTCCGTCGAAGTAGTGC -> ACTCCGTCGAAGTAGTGCC
GCCATTGAAGTCTGGTGAA -> CCATTGAAGTCTGGTGAAT
CTAGAATGGTAAGAGTTAG -> TAGAATGGTAAGAGTTAGG
CCAGCGAGAAGCAGTATGC -> CAGCGAGAAGCAGTATGCG
ATACCGAAGGTTAAAGTTT -> TACCGAAGGTTAAAGTTTC
ATTATATTGACAAAACTCC -> TTATATTGACAAAACTCCT
CCCACTGGGAGCAACGATT -> CCACTGGGAGCAACGATTG
CCGGGCCGCCTGGTAACAT -> CGGGCCGCCTGGTAACATT
CGCTGTCATGAGGATGTTT -> GCTGTCATGAGGATGTTTT
CGAGATCGTTTCTAAAGAC -> GAGATCGTTTCTAAAGACA
CCGGTTAGATGCCCACCAA -> CGGTTAGATGCCCACCAAT
AAGAGACTGTTGAACGTAC -> AGAGACTGTTGAACGTACA
ATCCCCGCTGGTAGTAACC -> TCCCCGCTGGTAGTAACCT
AGAATGGCACTGTATTCCA -> GAATGGCACTGTATTCCAT
CAAGCTCCCCTCCATGAGA -> AAGCTCCCCTCCATGAGAC
GAGACATCAGCGCTTAAAA -> AGACATCAGCGCTTAAAAA
GTTACAACCGCCGTCGTTG -> TTACAACCGCCGTCGTTGG
ACCCGAGCTTGGTTACAAA -> CCCGAGCTTGGTTACAAAT
CTCCCGGTACGCCCCCATC -> TCCCGGTACGCCCCCATCG
TAGTTTCGCGAAGGACCCA -> AGTTTCGCGAAGGACCCAT
TACGGCCGCCGTCACTCTA -> ACGGCCGCCGTCACTCTAG
GGCACGAGGGAGCTAGCCA -> GCACGAGGGAGCTAGCCAC
CAAAGCCTTGATACCGAAG -> AAAGCCTTGATACCGAAGG
CTAAAAGGCCGACCATGTC -> TAAAAGGCCGACCATGTCA
CCGCGGCCCCATCCCCGCT -> CGCGGCCCCATCCCCGCTG
CCATAAACCGGTTAGATGC -> CATAAACCGGTTAGATGCC
AGAATGATAAGTTACAACC -> GAATGATAAGTTACAACCG
AAAATCTTGTGTCCGACTC -> AAATCTTGTGTCCGACTCA
CACCCACCGTTTCTAACAA -> ACCCACCGTTTCTAACAAA
GGTCTAAAAGAGACTGTTG -> GTCTAAAAGAGACTGTTGA
AGATACGATTAGTAGTCTA -> GATACGATTAGTAGTCTAT
AAAGTAACTCAAAATATTA -> AAGTAACTCAAAATATTAG
TCTATCGTGGTCCCTCGCT -> CTATCGTGGTCCCTCGCTA
GCTCGTGCGGTCTTGATGG -> CTCGTGCGGTCTTGATGGC
CGTACCTGTGAAATCTCTA -> GTACCTGTGAAATCTCTAT
CTATAGTGTGCGCATTGGA -> TATAGTGTGCGCATTGGAC
TTCCATAAACCGGTTAGAT -> TCCATAAACCGGTTAGATG
GTCTAAAAGAGACTGTTGA -> TCTAAAAGAGACTGTTGAA
GCAATGGAGGACATATTAA -> CAATGGAGGACATATTAAA
ACACCATGCGGGCCGTAAA -> CACCATGCGGGCCGTAAAA
CGTTCCATAAACCGGTTAG -> GTTCCATAAACCGGTTAGA
GTAACCTTAGTCGCTCGGC -> TAACCTTAGTCGCTCGGCG
ATCTGATTATACCCCACTG -> TCTGATTATACCCCACTGG
GTAACTCAAAATATTAGTT -> TAACTCAAAATATTAGTTT
CATCGGTCTAAAAGAGACT -> ATCGGTCTAAAAGAGACTG
CCGGGCCCATCGAAATGGG -> CGGGCCCATCGAAATGGGG
ACCCTTGTCTCCGCCTTTG -> CCCTTGTCTCCGCCTTTGG
GTGTATTTTCCGTGTGACA -> TGTATTTTCCGTGTGACAC
AATACAGGAACTTCAGAGG -> ATACAGGAACTTCAGAGGC
AGTCCTGAAGAAGATGTGC -> GTCCTGAAGAAGATGTGCT
TAGTCTTTTGACGGCGCAA -> AGTCTTTTGACGGCGCAAA
ACCCATCGGTCTAAAAGAG -> CCCATCGGTCTAAAAGAGA
GCCCATCGAAATGGGGAGG -> CCCATCGAAATGGGGAGGA
CCGCCGTCACTCTAGGTAC -> CGCCGTCACTCTAGGTACG
GGATACCGTGTTCATATCT -> GATACCGTGTTCATATCTG
TAAGAGTTAGGACTGAAAT -> AAGAGTTAGGACTGAAATG
TCTCGGCTTGTCACAATGT -> CTCGGCTTGTCACAATGTT
AAGATCTCTTAGTTACCTC -> AGATCTCTTAGTTACCTCC
GGCGTACTTAACGTTCCCG -> GCGTACTTAACGTTCCCGT
TTAAGGAGCGAATCGCGAG -> TAAGGAGCGAATCGCGAGA
GAAGGCACGTGCCTGATGA -> AAGGCACGTGCCTGATGAT
TGGTGAATGGCTGTAGCGT -> GGTGAATGGCTGTAGCGTG
GAGGGAGCTAGCCACTAGT -> AGGGAGCTAGCCACTAGTC
AGCTGAGACTTTACCGTGT -> GCTGAGACTTTACCGTGTA
TGCGCATTGGACGCGTTGA -> GCGCATTGGACGCGTTGAG
CTTTACCGTGTAGGAGCCC -> TTTACCGTGTAGGAGCCCA
GCCCATCCAGAAGTCGCCA -> CCCATCCAGAAGTCGCCAC
GCTCGGATTGCAACACACA -> CTCGGATTGCAACACACAG
CTGGTGATTGAACTGCGGT -> TGGTGATTGAACTGCGGTG
AAAATACATATATGAAGGG -> AAATACATATATGAAGGGC
AAGGAGCGAATCGCGAGAG -> AGGAGCGAATCGCGAGAGG
CTGTCATGAGGATGTTTTA -> TGTCATGAGGATGTTTTAA
AGAATGGTAAGAGTTAGGA -> GAATGGTAAGAGTTAGGAC
AAGCTCCCCTCCATGAGAC -> AGCTCCCCTCCATGAGACT
GGGATTTCGTCGATTTATG -> GGATTTCGTCGATTTATGA
TCCCCTCCATGAGACTTGG -> CCCCTCCATGAGACTTGGC
ATTAAAAAACTAAATATCG -> TTAAAAAACTAAATATCGG
CTGGTCCATTCAAGCTCCC -> TGGTCCATTCAAGCTCCCC
TAGAAGCGCATCAATCGTC -> AGAAGCGCATCAATCGTCC
TGTTACTCGCCATTGAAGT -> GTTACTCGCCATTGAAGTC
GACTGAAATGGGCGCAGCT -> ACTGAAATGGGCGCAGCTG
GTCGCCACCCTTTGACCCT -> TCGCCACCCTTTGACCCTA
CGTGTGACACCATGCGGGC -> GTGTGACACCATGCGGGCC
GAATCCGGGCCGCCTGGTA -> AATCCGGGCCGCCTGGTAA
TTGGAGTTATTGGGCTGGG -> TGGAGTTATTGGGCTGGGT
GGTTAAAGTTTCCCGATAA -> GTTAAAGTTTCCCGATAAA
AAAAGTTGGCTTTAACGTA -> AAAGTTGGCTTTAACGTAG
AGCTACATCTTTATCATGA -> GCTACATCTTTATCATGAC
CGGCTTGTCACAATGTTCG -> GGCTTGTCACAATGTTCGT
CGCGCTGTCATGAGGATGT -> GCGCTGTCATGAGGATGTT
TAGACTGGTGATTGAACTG -> AGACTGGTGATTGAACTGC
CTCGTTGGGAATCTCATGA -> TCGTTGGGAATCTCATGAT
ACAGAACACAGATCGCGTT -> CAGAACACAGATCGCGTTC
ACCATGCGGGCCGTAAAAT -> CCATGCGGGCCGTAAAATG
TAGTCTATGCTAGAATGGT -> AGTCTATGCTAGAATGGTA
CCTGAGAATACAGATCGTG -> CTGAGAATACAGATCGTGC
TGCTATGGCTGGCGTGCAG -> GCTATGGCTGGCGTGCAGC
AGCCTAGTCGGGTGGAGTG -> GCCTAGTCGGGTGGAGTGT
ATGAGGATGTTTTAAGTCA -> TGAGGATGTTTTAAGTCAG
ATCTCTTAGTTACCTCCGT -> TCTCTTAGTTACCTCCGTG
TCATGCAATGGAGGACATA -> CATGCAATGGAGGACATAT
CGTTTCTAAAGACATATCC -> GTTTCTAAAGACATATCCA
ACATGAATCAAAGTACCAT -> CATGAATCAAAGTACCATG
GACCCTCGGTTGCGCCTTA -> ACCCTCGGTTGCGCCTTAA
CGCTTGACCCTCACGCAGG -> GCTTGACCCTCACGCAGGT
GGCTGGCGTGCAGCGCCGG -> GCTGGCGTGCAGCGCCGGT
AAAGTTGGCTTTAACGTAG -> AAGTTGGCTTTAACGTAGC
GGTCCCTCGCTAACTAGCT -> GTCCCTCGCTAACTAGCTT
GTCTATGCTAGAATGGTAA -> TCTATGCTAGAATGGTAAG
AAGTCGCCACCCTTTGACC -> AGTCGCCACCCTTTGACCC
TAAAGTAACTCAAAATATT -> AAAGTAACTCAAAATATTA
GTCTTGATGGCTCGGATTG -> TCTTGATGGCTCGGATTGC
AGTTACAACCGCCGTCGTT -> GTTACAACCGCCGTCGTTG
ATCATGACCCTCGGTTGCG -> TCATGACCCTCGGTTGCGC
CACTGGTGTATTATATTGA -> ACTGGTGTATTATATTGAC
TGAATCCGGGCCGCCTGGT -> GAATCCGGGCCGCCTGGTA
CTGTTGAACGTACAGCCAC -> TGTTGAACGTACAGCCACC
CTCCGTCGAAGTAGTGCCA -> TCCGTCGAAGTAGTGCCAG
GCGGAGTATATTATGAAGG -> CGGAGTATATTATGAAGGC
CGGTGCTCCCGGTACGCCC -> GGTGCTCCCGGTACGCCCC
TACCCTTGTCTCCGCCTTT -> ACCCTTGTCTCCGCCTTTG
GACCCATCGGTCTAAAAAT -> ACCCATCGGTCTAAAAATA
CCGTGCTATGGCTGGCGTG -> CGTGCTATGGCTGGCGTGC
GCGGCCGCCGGTCACAGAA -> CGGCCGCCGGTCACAGAAC
AAAAGGCCGACCATGTCAG -> AAAGGCCGACCATGTCAGA
CACAGAGAATCCGCTACCA -> ACAGAGAATCCGCTACCAC
GGCCGCCGTCACTCTAGGT -> GCCGCCGTCACTCTAGGTA
AAAACTAAATATCGGAGAA -> AAACTAAATATCGGAGAAG
ATTATACCCCACTGGGAGC -> TTATACCCCACTGGGAGCA
GTTAAAGTTTCCCGATAAA -> TTAAAGTTTCCCGATAAAT
TTAAAGTAACTCAAAATAT -> TAAAGTAACTCAAAATATT
CAGCTGAGACTTTACCGTG -> AGCTGAGACTTTACCGTGT
GGTCTTGATGGCTCGGATT -> GTCTTGATGGCTCGGATTG
AGCGCCGGTAAGGCCGTTC -> GCGCCGGTAAGGCCGTTCA
GCAGAGTCGGAAAGTTGTT -> CAGAGTCGGAAAGTTGTTA
ATATTGACAAAACTCCTAA -> TATTGACAAAACTCCTAAT
TGCAGGTGAAGGCGTACTT -> GCAGGTGAAGGCGTACTTA
GAAGATGTGCTCGAGATCG -> AAGATGTGCTCGAGATCGT
TAAAAGGCCGACCATGTCA -> AAAAGGCCGACCATGTCAG
ACAAATTGAGACATCAGCG -> CAAATTGAGACATCAGCGC
TACAAGATTCATTTTGCCG -> ACAAGATTCATTTTGCCGT
GGAGTTATTGGGCTGGGTT -> GAGTTATTGGGCTGGGTTC
GCTATGGCTGGCGTGCAGC -> CTATGGCTGGCGTGCAGCG
GGAGGGGCGATCTATAGTG -> GAGGGGCGATCTATAGTGT
ACCCCACTGGGAGCAACGA -> CCCCACTGGGAGCAACGAT
TGGGAGCAACGATTGCCGT -> GGGAGCAACGATTGCCGTA
CTGTTATTTTATACCCTTG -> TGTTATTTTATACCCTTGT
GGAACGTAGGCGGTCTTGA -> GAACGTAGGCGGTCTTGAT
CGCAGCTGAGACTTTACCG -> GCAGCTGAGACTTTACCGT
GGAGAAGCGGTCTTGATGG -> GAGAAGCGGTCTTGATGGC
CCCCTCCATGAGACTTGGC -> CCCTCCATGAGACTTGGCG
TATTATGGATGGCGGCCGC -> ATTATGGATGGCGGCCGCC
CACACAGACCCATCGGTCT -> ACACAGACCCATCGGTCTA
AGTAGTCTATGCTAGAATG -> GTAGTCTATGCTAGAATGG
TCCATAAACCGGTTAGATG -> CCATAAACCGGTTAGATGC
TTCTAACAAAAGCCTATAC -> TCTAACAAAAGCCTATACG
TGACCTGAGAATACAGATC -> GACCTGAGAATACAGATCG
GGACCCATCGGTATCTGAT -> GACCCATCGGTATCTGATT
GGACGCGTTGAGTCTAGCG -> GACGCGTTGAGTCTAGCGT
CTAAAGACATATCCAATGA -> TAAAGACATATCCAATGAT
TATCACACAGAGAATCCGC -> ATCACACAGAGAATCCGCT
AAGCCTTGATACCGAAGGT -> AGCCTTGATACCGAAGGTT
AGGAGCGAATCGCGAGAGG -> GGAGCGAATCGCGAGAGGA
CCACGATCCGGATACCGTG -> CACGATCCGGATACCGTGT
AAGTTTCCCGATAAATCTT -> AGTTTCCCGATAAATCTTT
CTTCAGAGGCTGTCCGCTT -> TTCAGAGGCTGTCCGCTTG
GAGCGAATCGCGAGAGGAG -> AGCGAATCGCGAGAGGAGG
CTTGACCCTCACGCAGGTA -> TTGACCCTCACGCAGGTAC
GGCTTTAACGTAGCATGCA -> GCTTTAACGTAGCATGCAG
TGGTACTCGCTCACCGCCA -> GGTACTCGCTCACCGCCAG
CGCTTATCACACAGAGAAT -> GCTTATCACACAGAGAATC
ACAGGAACTTCAGAGGCTG -> CAGGAACTTCAGAGGCTGT
ACATCTTTATCATGACCCT -> CATCTTTATCATGACCCTC
GAGGACATATTAAAAAACT -> AGGACATATTAAAAAACTA
TGGTAGTAACCTTAGTCGC -> GGTAGTAACCTTAGTCGCT
CGATTTATGAATCCGGGCC -> GATTTATGAATCCGGGCCG
TCTAAAGACATATCCAATG -> CTAAAGACATATCCAATGA
TATTGGGCTGGGTTCTCGG -> ATTGGGCTGGGTTCTCGGC
CTACACACAGGTAGTCTAG -> TACACACAGGTAGTCTAGA
GTACACCCGAGCTTGGTTA -> TACACCCGAGCTTGGTTAC
AGTCTTTTGACGGCGCAAA -> GTCTTTTGACGGCGCAAAG
AGATGTGCTCGAGATCGTT -> GATGTGCTCGAGATCGTTT
TTGAAGTCTGGTGAATGGC -> TGAAGTCTGGTGAATGGCT
TTCGCGAAGGACCCATCGG -> TCGCGAAGGACCCATCGGT
TGCGTACACCCGAGCTTGG -> GCGTACACCCGAGCTTGGT
AACTCCTAATGTTAAGGAG -> ACTCCTAATGTTAAGGAGC
GAAGACCTCTTTCGGGATT -> AAGACCTCTTTCGGGATTT
GCCACCCAAAGCCTTGATA -> CCACCCAAAGCCTTGATAC
ATCTTTAGTTTCGCGAAGG -> TCTTTAGTTTCGCGAAGGA
CCATCTGGTCCATTCAAGC -> CATCTGGTCCATTCAAGCT
GCTCTGCGATACATTCCAA -> CTCTGCGATACATTCCAAG
CGATTAGTAGTCTATGCTA -> GATTAGTAGTCTATGCTAG
TGATGGCTCGGCCGGCGAA -> GATGGCTCGGCCGGCGAAT
CATGATTAATTTCGTTCTT -> ATGATTAATTTCGTTCTTA
ACGTAGGCGGTCTTGATGG -> CGTAGGCGGTCTTGATGGC
ACACAGAGAATCCGCTACC -> CACAGAGAATCCGCTACCA
TGTAGGAGCCCATCCAGAA -> GTAGGAGCCCATCCAGAAG
AAGTACCATGGAACGTAGG -> AGTACCATGGAACGTAGGC
GGTTTCCTTGACGCAGACC -> GTTTCCTTGACGCAGACCC
TGACTCCGCGGCCCCATCC -> GACTCCGCGGCCCCATCCC
AAGCCGATAATCGGAGATA -> AGCCGATAATCGGAGATAT
GTCAGTAGCGCTTATCACA -> TCAGTAGCGCTTATCACAC
TCGGCTTGTCACAATGTTC -> CGGCTTGTCACAATGTTCG
TCCGAGCCACTGGTGTATT -> CCGAGCCACTGGTGTATTA
TGTTGTAATACCAGGCCCG -> GTTGTAATACCAGGCCCGC
ATATCGGAGAAGCGGTCTT -> TATCGGAGAAGCGGTCTTG
CGGTACGCCCCCATCGCGG -> GGTACGCCCCCATCGCGGT
TCGTCGATTTATGAATCCG -> CGTCGATTTATGAATCCGG
CTAAAAGAGACTGTTGAAC -> TAAAAGAGACTGTTGAACG
TATTGACAAAACTCCTAAT -> ATTGACAAAACTCCTAATG
ATAGTGTGCGCATTGGACG -> TAGTGTGCGCATTGGACGC
AGCAACGATTGCCGTAGTA -> GCAACGATTGCCGTAGTAA
TTTAGTTTCGCGAAGGACC -> TTAGTTTCGCGAAGGACCC
CATTGAAGTCTGGTGAATG -> ATTGAAGTCTGGTGAATGG
TCCCGTGGTGACTCCGCGG -> CCCGTGGTGACTCCGCGGC
TCCGTGTGACACCATGCGG -> CCGTGTGACACCATGCGGG
TATAGTGTGCGCATTGGAC -> ATAGTGTGCGCATTGGACG
GCGGTGCTCCCGGTACGCC -> CGGTGCTCCCGGTACGCCC
CACGAGTCAGAATCCTCTG -> ACGAGTCAGAATCCTCTGT
GCCTATACGAGGCATCAGC -> CCTATACGAGGCATCAGCA
ACGCAGGTACAAGATTCAT -> CGCAGGTACAAGATTCATT
AAATACATATATGAAGGGC -> AATACATATATGAAGGGCT
ACCTCTTTCGGGATTTCGT -> CCTCTTTCGGGATTTCGTC
GAATCGCGAGAGGAGGGGC -> AATCGCGAGAGGAGGGGCG
AGGCGTACTTAACGTTCCC -> GGCGTACTTAACGTTCCCG
ATTTCGTTCTTAGACTGGT -> TTTCGTTCTTAGACTGGTG
CACAGAACACAGATCGCGT -> ACAGAACACAGATCGCGTT
CATTACGCCGGGCCCATCG -> ATTACGCCGGGCCCATCGA
AATACCAGGCCCGCAGATA -> ATACCAGGCCCGCAGATAC
TGATGGCTCGTGCGGTCTT -> GATGGCTCGTGCGGTCTTG
ATTGTCATGCAATGGAGGA -> TTGTCATGCAATGGAGGAC
GCCGTCACTCTAGGTACGT -> CCGTCACTCTAGGTACGTC
GGCCGTTCACCCACCGTTT -> GCCGTTCACCCACCGTTTC
ATGCCCACCAATTAAAACA -> TGCCCACCAATTAAAACAT
TTAGATGCCCACCAATTAA -> TAGATGCCCACCAATTAAA
CCCATCGGTCTAAAAGTTG -> CCATCGGTCTAAAAGTTGG
AGAATCCTCTGTCATCGAT -> GAATCCTCTGTCATCGATC
CAGCAGAAGGCACGTGCCT -> AGCAGAAGGCACGTGCCTG
CTCATGATTAATTTCGTTC -> TCATGATTAATTTCGTTCT
TCAAATTATTGTCATGCAA -> CAAATTATTGTCATGCAAT
GACTCAAGGAGAAGGCAAC -> ACTCAAGGAGAAGGCAACT
ATTAATTTCGTTCTTAGAC -> TTAATTTCGTTCTTAGACT
CGATAAATCTTTAGTTTCG -> GATAAATCTTTAGTTTCGC
TAGAGCTGGTATTATGGAT -> AGAGCTGGTATTATGGATG
GTCATGAGGATGTTTTAAG -> TCATGAGGATGTTTTAAGT
ATGATAAGTTACAACCGCC -> TGATAAGTTACAACCGCCG
CTCCGCGGCCCCATCCCCG -> TCCGCGGCCCCATCCCCGC
CTCTGTTATTTTATACCCT -> TCTGTTATTTTATACCCTT
ATACATATATGAAGGGCTA -> TACATATATGAAGGGCTAA
TTCATTTTGCCGTGCTATG -> TCATTTTGCCGTGCTATGG
TCCTCTGTCATCGATCTTA -> CCTCTGTCATCGATCTTAG
TATTTTATACCCTTGTCTC -> ATTTTATACCCTTGTCTCC
AAGTTACAACCGCCGTCGT -> AGTTACAACCGCCGTCGTT
CTCGGTTTCCTTGACGCAG -> TCGGTTTCCTTGACGCAGA
ACTGGTGTATTATATTGAC -> CTGGTGTATTATATTGACA
GGCTCGGATTGCAACACAC -> GCTCGGATTGCAACACACA
CCCTAGTCCGTGGGGTGAC -> CCTAGTCCGTGGGGTGACC
TAGTGGTCGGGGCACGAGG -> AGTGGTCGGGGCACGAGGG
CCATCGGTCTAAAAGTTGG -> CATCGGTCTAAAAGTTGGC
AGTAACTCAAAATATTAGT -> GTAACTCAAAATATTAGTT
TACCGTGTTCATATCTGGC -> ACCGTGTTCATATCTGGCA
TGAGGATGTTTTAAGTCAG -> GAGGATGTTTTAAGTCAGT
CAAAACTCCTAATGTTAAG -> AAAACTCCTAATGTTAAGG
ACAAAAGCCTATACGAGGC -> CAAAAGCCTATACGAGGCA
AAAAAACTAAATATCGGAG -> AAAAACTAAATATCGGAGA
GCGCGCTGTCATGAGGATG -> CGCGCTGTCATGAGGATGT
TGCGGTGGGTTTGATTTCA -> GCGGTGGGTTTGATTTCAA
CTCGCTCACCGCCAGCGAG -> TCGCTCACCGCCAGCGAGA
GATGTGCTCGAGATCGTTT -> ATGTGCTCGAGATCGTTTC
AGAGTGTTGTAATACCAGG -> GAGTGTTGTAATACCAGGC
TTATCATGACCCTCGGTTG -> TATCATGACCCTCGGTTGC
ACGAGGCATCAGCAGAAGG -> CGAGGCATCAGCAGAAGGC
ATGGCACTGTATTCCATCT -> TGGCACTGTATTCCATCTG
ATATGAAGGGCTAAGCTAC -> TATGAAGGGCTAAGCTACA
ACAATGTTCGTAATACAGG -> CAATGTTCGTAATACAGGA
GTACCTGTGAAATCTCTAT -> TACCTGTGAAATCTCTATC
ATACAGATCGTGCAGAGTC -> TACAGATCGTGCAGAGTCG
TTCAGAGGCTGTCCGCTTG -> TCAGAGGCTGTCCGCTTGA
CCTGATGATTTCATGCGAG -> CTGATGATTTCATGCGAGA
CAATGATAGCAGCCTAGTC -> AATGATAGCAGCCTAGTCG
CTTTCTTTTCGCGTAGAAG -> TTTCTTTTCGCGTAGAAGC
GACATATCCAATGATAGCA -> ACATATCCAATGATAGCAG
ACGAGTCAGAATCCTCTGT -> CGAGTCAGAATCCTCTGTC
GTTCTTAGACTGGTGATTG -> TTCTTAGACTGGTGATTGA
AGCGCATCAATCGTCCACC -> GCGCATCAATCGTCCACCG
GCCGCCGTCACTCTAGGTA -> CCGCCGTCACTCTAGGTAC
GGTCTTGATGGCTCGTGCG -> GTCTTGATGGCTCGTGCGG
TGTATTCCATCTGGTCCAT -> GTATTCCATCTGGTCCATT
TATCGGAGAAGCGGTCTTG -> ATCGGAGAAGCGGTCTTGA
ATATACATCCCTCGTTGGG -> TATACATCCCTCGTTGGGA
TTTGCCGTGCTATGGCTGG -> TTGCCGTGCTATGGCTGGC
GGTCTTGATGGCTCGGCCG -> GTCTTGATGGCTCGGCCGG
TAGTCCTGAAGAAGATGTG -> AGTCCTGAAGAAGATGTGC
TTAGTTACCTCCGTGCGTA -> TAGTTACCTCCGTGCGTAC
ACAAGATTCATTTTGCCGT -> CAAGATTCATTTTGCCGTG
CAATTAAAACATAGTCTTT -> AATTAAAACATAGTCTTTT
CTCACGCAGGTACAAGATT -> TCACGCAGGTACAAGATTC
CGTACACCCGAGCTTGGTT -> GTACACCCGAGCTTGGTTA
GAAATGGGCGCAGCTGAGA -> AAATGGGCGCAGCTGAGAC
TACCCCACTGGGAGCAACG -> ACCCCACTGGGAGCAACGA
GATGGCTCGGTTTCCTTGA -> ATGGCTCGGTTTCCTTGAC
CCATGGAACGTAGGCGGTC -> CATGGAACGTAGGCGGTCT
GGCTGGGTTCTCGGCTTGT -> GCTGGGTTCTCGGCTTGTC
AATGGGCGCAGCTGAGACT -> ATGGGCGCAGCTGAGACTT
TGGCTCGTGCGGTCTTGAT -> GGCTCGTGCGGTCTTGATG
CGTAAAATGGTACTCGCTC -> GTAAAATGGTACTCGCTCA
TGTTAAGGAGCGAATCGCG -> GTTAAGGAGCGAATCGCGA
GACCCTCACGCAGGTACAA -> ACCCTCACGCAGGTACAAG
GTCCGCTTGACCCTCACGC -> TCCGCTTGACCCTCACGCA
CTTTAACGTAGCATGCAGG -> TTTAACGTAGCATGCAGGT
TATCCAATGATAGCAGCCT -> ATCCAATGATAGCAGCCTA
GAGGGGCGATCTATAGTGT -> AGGGGCGATCTATAGTGTG
CTAGCCACTAGTCCTGAAG -> TAGCCACTAGTCCTGAAGA
AAGAGTTAGGACTGAAATG -> AGAGTTAGGACTGAAATGG
CAGAAGACCTCTTTCGGGA -> AGAAGACCTCTTTCGGGAT
ATAGAGCTGGTATTATGGA -> TAGAGCTGGTATTATGGAT
CAAACATGAATCAAAGTAC -> AAACATGAATCAAAGTACC
TTGAGTCTAGCGTACCTGT -> TGAGTCTAGCGTACCTGTG
ATCGTGCAGAGTCGGAAAG -> TCGTGCAGAGTCGGAAAGT
CGATTGCCGTAGTAACTTC -> GATTGCCGTAGTAACTTCT
ACCTCCGTGCGTACACCCG -> CCTCCGTGCGTACACCCGA
TGCTAGAATGGTAAGAGTT -> GCTAGAATGGTAAGAGTTA
CGGATTGCAACACACAGAC -> GGATTGCAACACACAGACC
TGTATTTTCCGTGTGACAC -> GTATTTTCCGTGTGACACC
AAGGGCTAAGCTACATCTT -> AGGGCTAAGCTACATCTTT
GTAATACAGGAACTTCAGA -> TAATACAGGAACTTCAGAG
GGAAAGTTGTTAAAGTAAC -> GAAAGTTGTTAAAGTAACT
CTCCCCTCCATGAGACTTG -> TCCCCTCCATGAGACTTGG
TGAAGGGCTAAGCTACATC -> GAAGGGCTAAGCTACATCT
TACATACACATTACGCCGG -> ACATACACATTACGCCGGG
TGCAACACACAGACCCATC -> GCAACACACAGACCCATCG
CACCCGAGCTTGGTTACAA -> ACCCGAGCTTGGTTACAAA
CTCACCGCCAGCGAGAAGC -> TCACCGCCAGCGAGAAGCA
CCCGCTGGTAGTAACCTTA -> CCGCTGGTAGTAACCTTAG
CTGATTATACCCCACTGGG -> TGATTATACCCCACTGGGA
CATTTTGCCGTGCTATGGC -> ATTTTGCCGTGCTATGGCT
CAGCGAGAAGCAGTATGCG -> AGCGAGAAGCAGTATGCGG
AGTTGTTAAAGTAACTCAA -> GTTGTTAAAGTAACTCAAA
GTTTCCCGATAAATCTTTA -> TTTCCCGATAAATCTTTAG
CGTGGTGACTCCGCGGCCC -> GTGGTGACTCCGCGGCCCC
GCCGTAGTAACTTCTCCAC -> CCGTAGTAACTTCTCCACG
CGTAGTAACTTCTCCACGA -> GTAGTAACTTCTCCACGAT
CCCATCGGTATCTGATTAT -> CCATCGGTATCTGATTATA
GTGTGACACCATGCGGGCC -> TGTGACACCATGCGGGCCG
ATTCATTTTGCCGTGCTAT -> TTCATTTTGCCGTGCTATG
ACGATTGCCGTAGTAACTT -> CGATTGCCGTAGTAACTTC
AGGCTCTTTCTTTTCGCGT -> GGCTCTTTCTTTTCGCGTA
GTACTTAACGTTCCCGTGG -> TACTTAACGTTCCCGTGGT
GGTCCGAGCCACTGGTGTA -> GTCCGAGCCACTGGTGTAT
TTGGACGCGTTGAGTCTAG -> TGGACGCGTTGAGTCTAGC
ATCGCGAGAGGAGGGGCGA -> TCGCGAGAGGAGGGGCGAT
GGTAACATTACTACACACA -> GTAACATTACTACACACAG
TGATAGCAGCCTAGTCGGG -> GATAGCAGCCTAGTCGGGT
ATCTTAGCAGGTCCGAGCC -> TCTTAGCAGGTCCGAGCCA
CAGGTACAAGATTCATTTT -> AGGTACAAGATTCATTTTG
CATCCCCGCTGGTAGTAAC -> ATCCCCGCTGGTAGTAACC
CCGTAGTAACTTCTCCACG -> CGTAGTAACTTCTCCACGA
TCGTTTCTAAAGACATATC -> CGTTTCTAAAGACATATCC
AAAGACATATCCAATGATA -> AAGACATATCCAATGATAG
GAGAATACAGATCGTGCAG -> AGAATACAGATCGTGCAGA
AGGTGTTACTCGCCATTGA -> GGTGTTACTCGCCATTGAA
TCTTTTCGCGTAGAAGCGC -> CTTTTCGCGTAGAAGCGCA
CGAGCTTGGTTACAAATTG -> GAGCTTGGTTACAAATTGA
GATACATTCCAAGATCTCT -> ATACATTCCAAGATCTCTT
ATACCGTGTTCATATCTGG -> TACCGTGTTCATATCTGGC
TTGGTTACAAATTGAGACA -> TGGTTACAAATTGAGACAT
GATTTCAAACATGAATCAA -> ATTTCAAACATGAATCAAA
TTATGGATGGCGGCCGCCG -> TATGGATGGCGGCCGCCGG
CATGAGACTTGGCGGCGAT -> ATGAGACTTGGCGGCGATG
TCATATCTGGCAGAGTGTT -> CATATCTGGCAGAGTGTTG
CCGGATACCGTGTTCATAT -> CGGATACCGTGTTCATATC
AAGGCGTACTTAACGTTCC -> AGGCGTACTTAACGTTCCC
GTTACGAGGTACGGCCGCC -> TTACGAGGTACGGCCGCCG
GATTATACCCCACTGGGAG -> ATTATACCCCACTGGGAGC
TTTCGTTCTTAGACTGGTG -> TTCGTTCTTAGACTGGTGA
ACTAGTCCTGAAGAAGATG -> CTAGTCCTGAAGAAGATGT
GCTGTACATACACATTACG -> CTGTACATACACATTACGC
AGTAGTGCCAGGTGTTACT -> GTAGTGCCAGGTGTTACTC
AAAAGAGACTGTTGAACGT -> AAAGAGACTGTTGAACGTA
TACATCCCTCGTTGGGAAT -> ACATCCCTCGTTGGGAATC
AGTTACCTCCGTGCGTACA -> GTTACCTCCGTGCGTACAC
CATCAGCGCTTAAAAATCT -> ATCAGCGCTTAAAAATCTT
ACATTACGCCGGGCCCATC -> CATTACGCCGGGCCCATCG
GAATCCTCTGTCATCGATC -> AATCCTCTGTCATCGATCT
ATTATGAAGGCTCTTTCTT -> TTATGAAGGCTCTTTCTTT
TAAAATGGTACTCGCTCAC -> AAAATGGTACTCGCTCACC
CCCACCGTTTCTAACAAAA -> CCACCGTTTCTAACAAAAG
GATGGTCAAATTATTGTCA -> ATGGTCAAATTATTGTCAT
AGACATATCCAATGATAGC -> GACATATCCAATGATAGCA
ATCAATCGTCCACCGAGAA -> TCAATCGTCCACCGAGAAG
TGGGCGCAGCTGAGACTTT -> GGGCGCAGCTGAGACTTTA
AGGAGGGGCGATCTATAGT -> GGAGGGGCGATCTATAGTG
TCTAAAAGAGACTGTTGAA -> CTAAAAGAGACTGTTGAAC
GGACTGAAATGGGCGCAGC -> GACTGAAATGGGCGCAGCT
AATGTCAGACCCATCGGTC -> ATGTCAGACCCATCGGTCT
CTTTGACCCTAGTCCGTGG -> TTTGACCCTAGTCCGTGGG
CAGAGTGTTGTAATACCAG -> AGAGTGTTGTAATACCAGG
CGTTGGGAATCTCATGATT -> GTTGGGAATCTCATGATTA
TCCAGAAGTCGCCACCCTT -> CCAGAAGTCGCCACCCTTT
CATTCCAAGATCTCTTAGT -> ATTCCAAGATCTCTTAGTT
GCAGGTACAAGATTCATTT -> CAGGTACAAGATTCATTTT
CACTCTAGGTACGTCCCTA -> ACTCTAGGTACGTCCCTAG
CACCCTTTGACCCTAGTCC -> ACCCTTTGACCCTAGTCCG
CTAGTCCTGAAGAAGATGT -> TAGTCCTGAAGAAGATGTG
TTACTACACACAGGTAGTC -> TACTACACACAGGTAGTCT
CGTTCACCCACCGTTTCTA -> GTTCACCCACCGTTTCTAA
TTGACAAAACTCCTAATGT -> TGACAAAACTCCTAATGTT
AAACATGAATCAAAGTACC -> AACATGAATCAAAGTACCA
CATCGATCTTAGCAGGTCC -> ATCGATCTTAGCAGGTCCG
ACCGTGTTCATATCTGGCA -> CCGTGTTCATATCTGGCAG
AATGGAGGACATATTAAAA -> ATGGAGGACATATTAAAAA
AGTTTCCCGATAAATCTTT -> GTTTCCCGATAAATCTTTA
CGTGCCTGATGATTTCATG -> GTGCCTGATGATTTCATGC
TGTCATGAGGATGTTTTAA -> GTCATGAGGATGTTTTAAG
TCGGTCTAAAAGAGACTGT -> CGGTCTAAAAGAGACTGTT
GCGCCTTAATAGCTGTACA -> CGCCTTAATAGCTGTACAT
TGCAATGGAGGACATATTA -> GCAATGGAGGACATATTAA
ACTCCGCGGCCCCATCCCC -> CTCCGCGGCCCCATCCCCG
GGTGTATTATATTGACAAA -> GTGTATTATATTGACAAAA
CGGCGCAAAGCCGATAATC -> GGCGCAAAGCCGATAATCG
GCCGTCGTTGGAGTTATTG -> CCGTCGTTGGAGTTATTGG
CGATACATTCCAAGATCTC -> GATACATTCCAAGATCTCT
CGGTCTAAAAATACATATA -> GGTCTAAAAATACATATAT
CCGAGCCACTGGTGTATTA -> CGAGCCACTGGTGTATTAT
CTTAGAATGGCACTGTATT -> TTAGAATGGCACTGTATTC
TGAAGTCTGGTGAATGGCT -> GAAGTCTGGTGAATGGCTG
CGTCGATTTATGAATCCGG -> GTCGATTTATGAATCCGGG
CAGATCGTGCAGAGTCGGA -> AGATCGTGCAGAGTCGGAA
TGTCACAATGTTCGTAATA -> GTCACAATGTTCGTAATAC
CGTGCAGAGTCGGAAAGTT -> GTGCAGAGTCGGAAAGTTG
TCGTGGTCCCTCGCTAACT -> CGTGGTCCCTCGCTAACTA
GTGCAGAGTCGGAAAGTTG -> TGCAGAGTCGGAAAGTTGT
CCGTGGGGTGACCTGAGAA -> CGTGGGGTGACCTGAGAAT
GGAGGACATATTAAAAAAC -> GAGGACATATTAAAAAACT
AAGTAGTGCCAGGTGTTAC -> AGTAGTGCCAGGTGTTACT
TGGCGGTGCTCCCGGTACG -> GGCGGTGCTCCCGGTACGC
CGGTCTTGATGGCTCGGTT -> GGTCTTGATGGCTCGGTTT
AGCCACCCAAAGCCTTGAT -> GCCACCCAAAGCCTTGATA
GATGGCGGCCGCCGGTCAC -> ATGGCGGCCGCCGGTCACA
CGGTCTTGATGGCTCGGAT -> GGTCTTGATGGCTCGGATT
TCCATCTGGTCCATTCAAG -> CCATCTGGTCCATTCAAGC
GTTGCGCCTTAATAGCTGT -> TTGCGCCTTAATAGCTGTA
AAAGCCTTGATACCGAAGG -> AAGCCTTGATACCGAAGGT
AATGGTACTCGCTCACCGC -> ATGGTACTCGCTCACCGCC
TCAAACATGAATCAAAGTA -> CAAACATGAATCAAAGTAC
GTCTAAAAGTTGGCTTTAA -> TCTAAAAGTTGGCTTTAAC
TCGCGTTCCATAAACCGGT -> CGCGTTCCATAAACCGGTT
TTATGAATCCGGGCCGCCT -> TATGAATCCGGGCCGCCTG
TAACGTTCCCGTGGTGACT -> AACGTTCCCGTGGTGACTC
ATCGGTCTAAAAGGCCGAC -> TCGGTCTAAAAGGCCGACC
CGTGCGGTCTTGATGGCTC -> GTGCGGTCTTGATGGCTCG
CTTTATCATGACCCTCGGT -> TTTATCATGACCCTCGGTT
CATCGGTCTAAAAATACAT -> ATCGGTCTAAAAATACATA
CATCGGTCTAAAAGGCCGA -> ATCGGTCTAAAAGGCCGAC