AAG -> AGA,AGA
AGA -> GAT
GAT -> ATT
ATT -> TTC
TTC -> TCT
TCT -> CTC,CTA
CTC -> TCT
CTA -> TAA
TAA -> AAG
CTAGATGAAGA -> TAGATGAAGAC
TAGATGAAGAC -> AGATGAAGACA
AGATGAAGACA -> GATGAAGACAC
GATGAAGACAC -> ATGAAGACACC
ATGAAGACACC -> TGAAGACACCA
TGAAGACACCA -> GAAGACACCAC
GAAGACACCAC -> AAGACACCACT
AAGACACCACT -> AGACACCACTC
AGACACCACTC -> GACACCACTCT
GACACCACTCT -> ACACCACTCTA
ACACCACTCTA -> CACCACTCTAC
CACCACTCTAC -> ACCACTCTACT
ACCACTCTACT -> CCACTCTACTT
CCACTCTACTT -> CACTCTACTTT
CACTCTACTTT -> ACTCTACTTTC
ACTCTACTTTC -> CTCTACTTTCG
CTCTACTTTCG -> TCTACTTTCGA
TCTACTTTCGA -> CTACTTTCGAC
CTACTTTCGAC -> TACTTTCGACA
TACTTTCGACA -> ACTTTCGACAG
ACTTTCGACAG -> CTTTCGACAGG
CTTTCGACAGG -> TTTCGACAGGG
TTTCGACAGGG -> TTCGACAGGGC
TTCGACAGGGC -> TCGACAGGGCG
TCGACAGGGCG -> CGACAGGGCGT
CGACAGGGCGT -> GACAGGGCGTA
GACAGGGCGTA -> ACAGGGCGTAG
ACAGGGCGTAG -> CAGGGCGTAGG
CAGGGCGTAGG -> AGGGCGTAGGA
AGGGCGTAGGA -> GGGCGTAGGAA
GGGCGTAGGAA -> GGCGTAGGAAT
GGCGTAGGAAT -> GCGTAGGAATA
GCGTAGGAATA -> CGTAGGAATAA
CGTAGGAATAA -> GTAGGAATAAA
GTAGGAATAAA -> TAGGAATAAAA
TAGGAATAAAA -> AGGAATAAAAT
AGGAATAAAAT -> GGAATAAAATA
GGAATAAAATA -> GAATAAAATAT
GAATAAAATAT -> AATAAAATATG
AATAAAATATG -> ATAAAATATGT
ATAAAATATGT -> TAAAATATGTC
TAAAATATGTC -> AAAATATGTCC
AAAATATGTCC -> AAATATGTCCC
AAATATGTCCC -> AATATGTCCCC
AATATGTCCCC -> ATATGTCCCCG
ATATGTCCCCG -> TATGTCCCCGA
TATGTCCCCGA -> ATGTCCCCGAC
ATGTCCCCGAC -> TGTCCCCGACC
TGTCCCCGACC -> GTCCCCGACCC
GTCCCCGACCC -> TCCCCGACCCC
TCCCCGACCCC -> CCCCGACCCCC
CCCCGACCCCC -> CCCGACCCCCC
CCCGACCCCCC -> CCGACCCCCCA
CCGACCCCCCA -> CGACCCCCCAA
CGACCCCCCAA -> GACCCCCCAAT
GACCCCCCAAT -> ACCCCCCAATG
ACCCCCCAATG -> CCCCCCAATGC
CCCCCCAATGC -> CCCCCAATGCG
CCCCCAATGCG -> CCCCAATGCGG
CCCCAATGCGG -> CCCAATGCGGG
CCCAATGCGGG -> CCAATGCGGGC
CCAATGCGGGC -> CAATGCGGGCT
CAATGCGGGCT -> AATGCGGGCTT
AATGCGGGCTT -> ATGCGGGCTTA
ATGCGGGCTTA -> TGCGGGCTTAG
TGCGGGCTTAG -> GCGGGCTTAGT
GCGGGCTTAGT -> CGGGCTTAGTT
CGGGCTTAGTT -> GGGCTTAGTTC
GGGCTTAGTTC -> GGCTTAGTTCC
GGCTTAGTTCC -> GCTTAGTTCCG
GCTTAGTTCCG -> CTTAGTTCCGC
CTTAGTTCCGC -> TTAGTTCCGCT
TTAGTTCCGCT -> TAGTTCCGCTC
TAGTTCCGCTC -> AGTTCCGCTCT
AGTTCCGCTCT -> GTTCCGCTCTT
GTTCCGCTCTT -> TTCCGCTCTTG
TTCCGCTCTTG -> TCCGCTCTTGC
TCCGCTCTTGC -> CCGCTCTTGCG
CCGCTCTTGCG -> CGCTCTTGCGC
CGCTCTTGCGC -> GCTCTTGCGCG
GCTCTTGCGCG -> CTCTTGCGCGA
CTCTTGCGCGA -> TCTTGCGCGAG
TCTTGCGCGAG -> CTTGCGCGAGA
CTTGCGCGAGA -> TTGCGCGAGAC
TTGCGCGAGAC -> TGCGCGAGACC
TGCGCGAGACC -> GCGCGAGACCC
GCGCGAGACCC -> CGCGAGACCCG
CGCGAGACCCG -> GCGAGACCCGG
GCGAGACCCGG -> CGAGACCCGGG
CGAGACCCGGG -> GAGACCCGGGT
GAGACCCGGGT -> AGACCCGGGTA
AGACCCGGGTA -> GACCCGGGTAA
GACCCGGGTAA -> ACCCGGGTAAC
ACCCGGGTAAC -> CCCGGGTAACC
CCCGGGTAACC -> CCGGGTAACCA
CCGGGTAACCA -> CGGGTAACCAC
CGGGTAACCAC -> GGGTAACCACC
GGGTAACCACC -> GGTAACCACCT
GGTAACCACCT -> GTAACCACCTG
GTAACCACCTG -> TAACCACCTGG
TAACCACCTGG -> AACCACCTGGA
AACCACCTGGA -> ACCACCTGGAG
ACCACCTGGAG -> CCACCTGGAGT
CCACCTGGAGT -> CACCTGGAGTC
CACCTGGAGTC -> ACCTGGAGTCC
ACCTGGAGTCC -> CCTGGAGTCCG
CCTGGAGTCCG -> CTGGAGTCCGT
CTGGAGTCCGT -> TGGAGTCCGTC
TGGAGTCCGTC -> GGAGTCCGTCC
GGAGTCCGTCC -> GAGTCCGTCCA
GAGTCCGTCCA -> AGTCCGTCCAC
AGTCCGTCCAC -> GTCCGTCCACC
GTCCGTCCACC -> TCCGTCCACCG
TCCGTCCACCG -> CCGTCCACCGT
CCGTCCACCGT -> CGTCCACCGTG
CGTCCACCGTG -> GTCCACCGTGT
GTCCACCGTGT -> TCCACCGTGTT
TCCACCGTGTT -> CCACCGTGTTA
CCACCGTGTTA -> CACCGTGTTAG
CACCGTGTTAG -> ACCGTGTTAGC
ACCGTGTTAGC -> CCGTGTTAGCC
CCGTGTTAGCC -> CGTGTTAGCCG
CGTGTTAGCCG -> GTGTTAGCCGA
GTGTTAGCCGA -> TGTTAGCCGAA
TGTTAGCCGAA -> GTTAGCCGAAT
GTTAGCCGAAT -> TTAGCCGAATT
TTAGCCGAATT -> TAGCCGAATTA
TAGCCGAATTA -> AGCCGAATTAC
AGCCGAATTAC -> GCCGAATTACT
GCCGAATTACT -> CCGAATTACTC
CCGAATTACTC -> CGAATTACTCT
CGAATTACTCT -> GAATTACTCTC
GAATTACTCTC -> AATTACTCTCA
AATTACTCTCA -> ATTACTCTCAC
ATTACTCTCAC -> TTACTCTCACC
TTACTCTCACC -> TACTCTCACCG
TACTCTCACCG -> ACTCTCACCGG
ACTCTCACCGG -> CTCTCACCGGC
CTCTCACCGGC -> TCTCACCGGCT
TCTCACCGGCT -> CTCACCGGCTT
CTCACCGGCTT -> TCACCGGCTTA
TCACCGGCTTA -> CACCGGCTTAC
CACCGGCTTAC -> ACCGGCTTACG
ACCGGCTTACG -> CCGGCTTACGC
CCGGCTTACGC -> CGGCTTACGCC
CGGCTTACGCC -> GGCTTACGCCC
GGCTTACGCCC -> GCTTACGCCCT
GCTTACGCCCT -> CTTACGCCCTT
CTTACGCCCTT -> TTACGCCCTTG
TTACGCCCTTG -> TACGCCCTTGA
TACGCCCTTGA -> ACGCCCTTGAG
ACGCCCTTGAG -> CGCCCTTGAGA
CGCCCTTGAGA -> GCCCTTGAGAG
GCCCTTGAGAG -> CCCTTGAGAGA
CCCTTGAGAGA -> CCTTGAGAGAG
CCTTGAGAGAG -> CTTGAGAGAGC
CTTGAGAGAGC -> TTGAGAGAGCC
TTGAGAGAGCC -> TGAGAGAGCCA
TGAGAGAGCCA -> GAGAGAGCCAC
GAGAGAGCCAC -> AGAGAGCCACG
AGAGAGCCACG -> GAGAGCCACGT
GAGAGCCACGT -> AGAGCCACGTA
AGAGCCACGTA -> GAGCCACGTAG
GAGCCACGTAG -> AGCCACGTAGC
AGCCACGTAGC -> GCCACGTAGCA
GCCACGTAGCA -> CCACGTAGCAG
CCACGTAGCAG -> CACGTAGCAGC
CACGTAGCAGC -> ACGTAGCAGCC
ACGTAGCAGCC -> CGTAGCAGCCG
CGTAGCAGCCG -> GTAGCAGCCGG
GTAGCAGCCGG -> TAGCAGCCGGT
TAGCAGCCGGT -> AGCAGCCGGTA
AGCAGCCGGTA -> GCAGCCGGTAC
GCAGCCGGTAC -> CAGCCGGTACG
CAGCCGGTACG -> AGCCGGTACGG
AGCCGGTACGG -> GCCGGTACGGA
GCCGGTACGGA -> CCGGTACGGAT
CCGGTACGGAT -> CGGTACGGATC
CGGTACGGATC -> GGTACGGATCG
GGTACGGATCG -> GTACGGATCGA
GTACGGATCGA -> TACGGATCGAC
TACGGATCGAC -> ACGGATCGACT
ACGGATCGACT -> CGGATCGACTA
CGGATCGACTA -> GGATCGACTAG
GGATCGACTAG -> GATCGACTAGC
GATCGACTAGC -> ATCGACTAGCA
ATCGACTAGCA -> TCGACTAGCAG
TCGACTAGCAG -> CGACTAGCAGA
CGACTAGCAGA -> GACTAGCAGAG
GACTAGCAGAG -> ACTAGCAGAGA
ACTAGCAGAGA -> CTAGCAGAGAT
CTAGCAGAGAT -> TAGCAGAGATG
TAGCAGAGATG -> AGCAGAGATGA
AGCAGAGATGA -> GCAGAGATGAC
GCAGAGATGAC -> CAGAGATGACT
CAGAGATGACT -> AGAGATGACTC
AGAGATGACTC -> GAGATGACTCT
GAGATGACTCT -> AGATGACTCTC
AGATGACTCTC -> GATGACTCTCA
GATGACTCTCA -> ATGACTCTCAT
ATGACTCTCAT -> TGACTCTCATA
TGACTCTCATA -> GACTCTCATAA
GACTCTCATAA -> ACTCTCATAAG
ACTCTCATAAG -> CTCTCATAAGC
CTCTCATAAGC -> TCTCATAAGCT
TCTCATAAGCT -> CTCATAAGCTG
CTCATAAGCTG -> TCATAAGCTGC
TCATAAGCTGC -> CATAAGCTGCA
CATAAGCTGCA -> ATAAGCTGCAG
ATAAGCTGCAG -> TAAGCTGCAGA
TAAGCTGCAGA -> AAGCTGCAGAT
AAGCTGCAGAT -> AGCTGCAGATC
AGCTGCAGATC -> GCTGCAGATCT
GCTGCAGATCT -> CTGCAGATCTG
CTGCAGATCTG -> TGCAGATCTGG
TGCAGATCTGG -> GCAGATCTGGG
GCAGATCTGGG -> CAGATCTGGGG
CAGATCTGGGG -> AGATCTGGGGG
AGATCTGGGGG -> GATCTGGGGGG
GATCTGGGGGG -> ATCTGGGGGGG
ATCTGGGGGGG -> TCTGGGGGGGA
TCTGGGGGGGA -> CTGGGGGGGAT
CTGGGGGGGAT -> TGGGGGGGATC
TGGGGGGGATC -> GGGGGGGATCA
GGGGGGGATCA -> GGGGGGATCAT
GGGGGGATCAT -> GGGGGATCATG
GGGGGATCATG -> GGGGATCATGC
GGGGATCATGC -> GGGATCATGCA
GGGATCATGCA -> GGATCATGCAT
GGATCATGCAT -> GATCATGCATC
GATCATGCATC -> ATCATGCATCC
ATCATGCATCC -> TCATGCATCCA
TCATGCATCCA -> CATGCATCCAA
CATGCATCCAA -> ATGCATCCAAG
ATGCATCCAAG -> TGCATCCAAGC
TGCATCCAAGC -> GCATCCAAGCT
GCATCCAAGCT -> CATCCAAGCTC
CATCCAAGCTC -> ATCCAAGCTCT
ATCCAAGCTCT -> TCCAAGCTCTG
TCCAAGCTCTG -> CCAAGCTCTGT
CCAAGCTCTGT -> CAAGCTCTGTA
CAAGCTCTGTA -> AAGCTCTGTAG
AAGCTCTGTAG -> AGCTCTGTAGG
AGCTCTGTAGG -> GCTCTGTAGGC
GCTCTGTAGGC -> CTCTGTAGGCC
CTCTGTAGGCC -> TCTGTAGGCCT
TCTGTAGGCCT -> CTGTAGGCCTT
CTGTAGGCCTT -> TGTAGGCCTTT
TGTAGGCCTTT -> GTAGGCCTTTA
GTAGGCCTTTA -> TAGGCCTTTAG
TAGGCCTTTAG -> AGGCCTTTAGT
AGGCCTTTAGT -> GGCCTTTAGTG
GGCCTTTAGTG -> GCCTTTAGTGG
GCCTTTAGTGG -> CCTTTAGTGGG
CCTTTAGTGGG -> CTTTAGTGGGC
CTTTAGTGGGC -> TTTAGTGGGCT
TTTAGTGGGCT -> TTAGTGGGCTC
TTAGTGGGCTC -> TAGTGGGCTCC
TAGTGGGCTCC -> AGTGGGCTCCA
AGTGGGCTCCA -> GTGGGCTCCAT
GTGGGCTCCAT -> TGGGCTCCATA
TGGGCTCCATA -> GGGCTCCATAT
GGGCTCCATAT -> GGCTCCATATT
GGCTCCATATT -> GCTCCATATTG
GCTCCATATTG -> CTCCATATTGC
CTCCATATTGC -> TCCATATTGCG
TCCATATTGCG -> CCATATTGCGT
CCATATTGCGT -> CATATTGCGTC
CATATTGCGTC -> ATATTGCGTCT
ATATTGCGTCT -> TATTGCGTCTA
TATTGCGTCTA -> ATTGCGTCTAG
ATTGCGTCTAG -> TTGCGTCTAGT
TTGCGTCTAGT -> TGCGTCTAGTC
TGCGTCTAGTC -> GCGTCTAGTCC
GCGTCTAGTCC -> CGTCTAGTCCC
CGTCTAGTCCC -> GTCTAGTCCCG
GTCTAGTCCCG -> TCTAGTCCCGT
TCTAGTCCCGT -> CTAGTCCCGTC
CTAGTCCCGTC -> TAGTCCCGTCG
TAGTCCCGTCG -> AGTCCCGTCGC
AGTCCCGTCGC -> GTCCCGTCGCT
GTCCCGTCGCT -> TCCCGTCGCTG
TCCCGTCGCTG -> CCCGTCGCTGG
CCCGTCGCTGG -> CCGTCGCTGGC
CCGTCGCTGGC -> CGTCGCTGGCT
CGTCGCTGGCT -> GTCGCTGGCTA
GTCGCTGGCTA -> TCGCTGGCTAG
TCGCTGGCTAG -> CGCTGGCTAGG
CGCTGGCTAGG -> GCTGGCTAGGT
GCTGGCTAGGT -> CTGGCTAGGTT
CTGGCTAGGTT -> TGGCTAGGTTA
TGGCTAGGTTA -> GGCTAGGTTAG
GGCTAGGTTAG -> GCTAGGTTAGG
GCTAGGTTAGG -> CTAGGTTAGGC
CTAGGTTAGGC -> TAGGTTAGGCT
TAGGTTAGGCT -> AGGTTAGGCTG
AGGTTAGGCTG -> GGTTAGGCTGC
GGTTAGGCTGC -> GTTAGGCTGCT
GTTAGGCTGCT -> TTAGGCTGCTG
TTAGGCTGCTG -> TAGGCTGCTGC
TAGGCTGCTGC -> AGGCTGCTGCT
AGGCTGCTGCT -> GGCTGCTGCTG
GGCTGCTGCTG -> GCTGCTGCTGG
GCTGCTGCTGG -> CTGCTGCTGGA
CTGCTGCTGGA -> TGCTGCTGGAT
TGCTGCTGGAT -> GCTGCTGGATC
GCTGCTGGATC -> CTGCTGGATCG
CTGCTGGATCG -> TGCTGGATCGA
TGCTGGATCGA -> GCTGGATCGAA
GCTGGATCGAA -> CTGGATCGAAA
CTGGATCGAAA -> TGGATCGAAAT
TGGATCGAAAT -> GGATCGAAATG
GGATCGAAATG -> GATCGAAATGC
GATCGAAATGC -> ATCGAAATGCT
ATCGAAATGCT -> TCGAAATGCTT
TCGAAATGCTT -> CGAAATGCTTT
CGAAATGCTTT -> GAAATGCTTTA
GAAATGCTTTA -> AAATGCTTTAC
AAATGCTTTAC -> AATGCTTTACC
AATGCTTTACC -> ATGCTTTACCT
ATGCTTTACCT -> TGCTTTACCTC
TGCTTTACCTC -> GCTTTACCTCC
GCTTTACCTCC -> CTTTACCTCCG
CTTTACCTCCG -> TTTACCTCCGT
TTTACCTCCGT -> TTACCTCCGTA
TTACCTCCGTA -> TACCTCCGTAC
TACCTCCGTAC -> ACCTCCGTACT
ACCTCCGTACT -> CCTCCGTACTG
CCTCCGTACTG -> CTCCGTACTGC
CTCCGTACTGC -> TCCGTACTGCG
TCCGTACTGCG -> CCGTACTGCGC
CCGTACTGCGC -> CGTACTGCGCA
CGTACTGCGCA -> GTACTGCGCAT
GTACTGCGCAT -> TACTGCGCATC
TACTGCGCATC -> ACTGCGCATCT
ACTGCGCATCT -> CTGCGCATCTC
CTGCGCATCTC -> TGCGCATCTCG
TGCGCATCTCG -> GCGCATCTCGA
GCGCATCTCGA -> CGCATCTCGAC
CGCATCTCGAC -> GCATCTCGACC
GCATCTCGACC -> CATCTCGACCA
CATCTCGACCA -> ATCTCGACCAA
ATCTCGACCAA -> TCTCGACCAAG
TCTCGACCAAG -> CTCGACCAAGT
CTCGACCAAGT -> TCGACCAAGTA
TCGACCAAGTA -> CGACCAAGTAC
CGACCAAGTAC -> GACCAAGTACT
GACCAAGTACT -> ACCAAGTACTG
ACCAAGTACTG -> CCAAGTACTGT
CCAAGTACTGT -> CAAGTACTGTT
CAAGTACTGTT -> AAGTACTGTTT
AAGTACTGTTT -> AGTACTGTTTC
AGTACTGTTTC -> GTACTGTTTCA
GTACTGTTTCA -> TACTGTTTCAA
TACTGTTTCAA -> ACTGTTTCAAT
ACTGTTTCAAT -> CTGTTTCAATT
CTGTTTCAATT -> TGTTTCAATTT
TGTTTCAATTT -> GTTTCAATTTG
GTTTCAATTTG -> TTTCAATTTGG
TTTCAATTTGG -> TTCAATTTGGG
TTCAATTTGGG -> TCAATTTGGGG
TCAATTTGGGG -> CAATTTGGGGT
CAATTTGGGGT -> AATTTGGGGTT
AATTTGGGGTT -> ATTTGGGGTTT
ATTTGGGGTTT -> TTTGGGGTTTT
TTTGGGGTTTT -> TTGGGGTTTTG
TTGGGGTTTTG -> TGGGGTTTTGT
TGGGGTTTTGT -> GGGGTTTTGTG
GGGGTTTTGTG -> GGGTTTTGTGT
GGGTTTTGTGT -> GGTTTTGTGTC
GGTTTTGTGTC -> GTTTTGTGTCC
GTTTTGTGTCC -> TTTTGTGTCCC
TTTTGTGTCCC -> TTTGTGTCCCA
TTTGTGTCCCA -> TTGTGTCCCAT
TTGTGTCCCAT -> TGTGTCCCATG
TGTGTCCCATG -> GTGTCCCATGG
GTGTCCCATGG -> TGTCCCATGGA
TGTCCCATGGA -> GTCCCATGGAT
GTCCCATGGAT -> TCCCATGGATT
TCCCATGGATT -> CCCATGGATTT
CCCATGGATTT -> CCATGGATTTA
CCATGGATTTA -> CATGGATTTAT
CATGGATTTAT -> ATGGATTTATG
ATGGATTTATG -> TGGATTTATGC
TGGATTTATGC -> GGATTTATGCA
GGATTTATGCA -> GATTTATGCAC
GATTTATGCAC -> ATTTATGCACT
ATTTATGCACT -> TTTATGCACTC
TTTATGCACTC -> TTATGCACTCG
TTATGCACTCG -> TATGCACTCGT
TATGCACTCGT -> ATGCACTCGTC
ATGCACTCGTC -> TGCACTCGTCA
TGCACTCGTCA -> GCACTCGTCAG
GCACTCGTCAG -> CACTCGTCAGT
CACTCGTCAGT -> ACTCGTCAGTC
ACTCGTCAGTC -> CTCGTCAGTCT
CTCGTCAGTCT -> TCGTCAGTCTT
TCGTCAGTCTT -> CGTCAGTCTTT
CGTCAGTCTTT -> GTCAGTCTTTT
GTCAGTCTTTT -> TCAGTCTTTTG
TCAGTCTTTTG -> CAGTCTTTTGA
CAGTCTTTTGA -> AGTCTTTTGAA
AGTCTTTTGAA -> GTCTTTTGAAC
GTCTTTTGAAC -> TCTTTTGAACG
TCTTTTGAACG -> CTTTTGAACGT
CTTTTGAACGT -> TTTTGAACGTA
TTTTGAACGTA -> TTTGAACGTAG
TTTGAACGTAG -> TTGAACGTAGT
TTGAACGTAGT -> TGAACGTAGTA
TGAACGTAGTA -> GAACGTAGTAT
GAACGTAGTAT -> AACGTAGTATT
AACGTAGTATT -> ACGTAGTATTG
ACGTAGTATTG -> CGTAGTATTGT
CGTAGTATTGT -> GTAGTATTGTG
GTAGTATTGTG -> TAGTATTGTGC
TAGTATTGTGC -> AGTATTGTGCT
AGTATTGTGCT -> GTATTGTGCTC
GTATTGTGCTC -> TATTGTGCTCG
TATTGTGCTCG -> ATTGTGCTCGG
ATTGTGCTCGG -> TTGTGCTCGGC
TTGTGCTCGGC -> TGTGCTCGGCA
TGTGCTCGGCA -> GTGCTCGGCAA
GTGCTCGGCAA -> TGCTCGGCAAT
TGCTCGGCAAT -> GCTCGGCAATC
GCTCGGCAATC -> CTCGGCAATCA
CTCGGCAATCA -> TCGGCAATCAA
TCGGCAATCAA -> CGGCAATCAAA
CGGCAATCAAA -> GGCAATCAAAG
GGCAATCAAAG -> GCAATCAAAGG
GCAATCAAAGG -> CAATCAAAGGG
CAATCAAAGGG -> AATCAAAGGGG
AATCAAAGGGG -> ATCAAAGGGGA
ATCAAAGGGGA -> TCAAAGGGGAA
TCAAAGGGGAA -> CAAAGGGGAAC
CAAAGGGGAAC -> AAAGGGGAACG
AAAGGGGAACG -> AAGGGGAACGA
AAGGGGAACGA -> AGGGGAACGAT
AGGGGAACGAT -> GGGGAACGATG
GGGGAACGATG -> GGGAACGATGA
GGGAACGATGA -> GGAACGATGAG
GGAACGATGAG -> GAACGATGAGC
GAACGATGAGC -> AACGATGAGCG
AACGATGAGCG -> ACGATGAGCGT
ACGATGAGCGT -> CGATGAGCGTG
CGATGAGCGTG -> GATGAGCGTGT
GATGAGCGTGT -> ATGAGCGTGTC
ATGAGCGTGTC -> TGAGCGTGTCG
TGAGCGTGTCG -> GAGCGTGTCGG
GAGCGTGTCGG -> AGCGTGTCGGT
AGCGTGTCGGT -> GCGTGTCGGTT
GCGTGTCGGTT -> CGTGTCGGTTG
CGTGTCGGTTG -> GTGTCGGTTGA
GTGTCGGTTGA -> TGTCGGTTGAT
TGTCGGTTGAT -> GTCGGTTGATG
GTCGGTTGATG -> TCGGTTGATGC
TCGGTTGATGC -> CGGTTGATGCA
CGGTTGATGCA -> GGTTGATGCAC
GGTTGATGCAC -> GTTGATGCACC
GTTGATGCACC -> TTGATGCACCG
TTGATGCACCG -> TGATGCACCGT
TGATGCACCGT -> GATGCACCGTA
GATGCACCGTA -> ATGCACCGTAT
ATGCACCGTAT -> TGCACCGTATA
TGCACCGTATA -> GCACCGTATAG
GCACCGTATAG -> CACCGTATAGT
CACCGTATAGT -> ACCGTATAGTA
ACCGTATAGTA -> CCGTATAGTAT
CCGTATAGTAT -> CGTATAGTATG
CGTATAGTATG -> GTATAGTATGG
GTATAGTATGG -> TATAGTATGGT
TATAGTATGGT -> ATAGTATGGTG
ATAGTATGGTG -> TAGTATGGTGG
TAGTATGGTGG -> AGTATGGTGGA
AGTATGGTGGA -> GTATGGTGGAC
GTATGGTGGAC -> TATGGTGGACA
TATGGTGGACA -> ATGGTGGACAG
ATGGTGGACAG -> TGGTGGACAGA
TGGTGGACAGA -> GGTGGACAGAC
GGTGGACAGAC -> GTGGACAGACG
GTGGACAGACG -> TGGACAGACGA
TGGACAGACGA -> GGACAGACGAG
GGACAGACGAG -> GACAGACGAGA
GACAGACGAGA -> ACAGACGAGAT
ACAGACGAGAT -> CAGACGAGATG
CAGACGAGATG -> AGACGAGATGA
AGACGAGATGA -> GACGAGATGAG
GACGAGATGAG -> ACGAGATGAGT
ACGAGATGAGT -> CGAGATGAGTG
CGAGATGAGTG -> GAGATGAGTGG
GAGATGAGTGG -> AGATGAGTGGT
AGATGAGTGGT -> GATGAGTGGTT
GATGAGTGGTT -> ATGAGTGGTTA
ATGAGTGGTTA -> TGAGTGGTTAC
TGAGTGGTTAC -> GAGTGGTTACC,GAGTGGTTACC
GAGTGGTTACC -> AGTGGTTACCG,AGTGGTTACCA
AGTGGTTACCG -> GTGGTTACCGC
GTGGTTACCGC -> TGGTTACCGCC
TGGTTACCGCC -> GGTTACCGCCC
GGTTACCGCCC -> GTTACCGCCCA
GTTACCGCCCA -> TTACCGCCCAC
TTACCGCCCAC -> TACCGCCCACG
TACCGCCCACG -> ACCGCCCACGG
ACCGCCCACGG -> CCGCCCACGGC
CCGCCCACGGC -> CGCCCACGGCT
CGCCCACGGCT -> GCCCACGGCTT
GCCCACGGCTT -> CCCACGGCTTC
CCCACGGCTTC -> CCACGGCTTCA
CCACGGCTTCA -> CACGGCTTCAA
CACGGCTTCAA -> ACGGCTTCAAT
ACGGCTTCAAT -> CGGCTTCAATG
CGGCTTCAATG -> GGCTTCAATGA
GGCTTCAATGA -> GCTTCAATGAT
GCTTCAATGAT -> CTTCAATGATC
CTTCAATGATC -> TTCAATGATCC
TTCAATGATCC -> TCAATGATCCT
TCAATGATCCT -> CAATGATCCTT
CAATGATCCTT -> AATGATCCTTC
AATGATCCTTC -> ATGATCCTTCA
ATGATCCTTCA -> TGATCCTTCAA
TGATCCTTCAA -> GATCCTTCAAC
GATCCTTCAAC -> ATCCTTCAACG
ATCCTTCAACG -> TCCTTCAACGC
TCCTTCAACGC -> CCTTCAACGCG
CCTTCAACGCG -> CTTCAACGCGT
CTTCAACGCGT -> TTCAACGCGTG
TTCAACGCGTG -> TCAACGCGTGT
TCAACGCGTGT -> CAACGCGTGTC
CAACGCGTGTC -> AACGCGTGTCC
AACGCGTGTCC -> ACGCGTGTCCT
ACGCGTGTCCT -> CGCGTGTCCTC
CGCGTGTCCTC -> GCGTGTCCTCC
GCGTGTCCTCC -> CGTGTCCTCCT
CGTGTCCTCCT -> GTGTCCTCCTC
GTGTCCTCCTC -> TGTCCTCCTCC
TGTCCTCCTCC -> GTCCTCCTCCG
GTCCTCCTCCG -> TCCTCCTCCGA
TCCTCCTCCGA -> CCTCCTCCGAT
CCTCCTCCGAT -> CTCCTCCGATC
CTCCTCCGATC -> TCCTCCGATCA
TCCTCCGATCA -> CCTCCGATCAA
CCTCCGATCAA -> CTCCGATCAAA
CTCCGATCAAA -> TCCGATCAAAT
TCCGATCAAAT -> CCGATCAAATA
CCGATCAAATA -> CGATCAAATAA
CGATCAAATAA -> GATCAAATAAG
GATCAAATAAG -> ATCAAATAAGG
ATCAAATAAGG -> TCAAATAAGGT
TCAAATAAGGT -> CAAATAAGGTC
CAAATAAGGTC -> AAATAAGGTCG
AAATAAGGTCG -> AATAAGGTCGG
AATAAGGTCGG -> ATAAGGTCGGC
ATAAGGTCGGC -> TAAGGTCGGCC
TAAGGTCGGCC -> AAGGTCGGCCT
AAGGTCGGCCT -> AGGTCGGCCTA
AGGTCGGCCTA -> GGTCGGCCTAC
GGTCGGCCTAC -> GTCGGCCTACA
GTCGGCCTACA -> TCGGCCTACAT
TCGGCCTACAT -> CGGCCTACATT
CGGCCTACATT -> GGCCTACATTG
GGCCTACATTG -> GCCTACATTGC
GCCTACATTGC -> CCTACATTGCG
CCTACATTGCG -> CTACATTGCGT
CTACATTGCGT -> TACATTGCGTT
TACATTGCGTT -> ACATTGCGTTA
ACATTGCGTTA -> CATTGCGTTAG
CATTGCGTTAG -> ATTGCGTTAGG
ATTGCGTTAGG -> TTGCGTTAGGA
TTGCGTTAGGA -> TGCGTTAGGAT
TGCGTTAGGAT -> GCGTTAGGATC
GCGTTAGGATC -> CGTTAGGATCA
CGTTAGGATCA -> GTTAGGATCAG
GTTAGGATCAG -> TTAGGATCAGG
TTAGGATCAGG -> TAGGATCAGGA
TAGGATCAGGA -> AGGATCAGGAA
AGGATCAGGAA -> GGATCAGGAAA
GGATCAGGAAA -> GATCAGGAAAA
GATCAGGAAAA -> ATCAGGAAAAG
ATCAGGAAAAG -> TCAGGAAAAGA
TCAGGAAAAGA -> CAGGAAAAGAC
CAGGAAAAGAC -> AGGAAAAGACA
AGGAAAAGACA -> GGAAAAGACAA
GGAAAAGACAA -> GAAAAGACAAC
GAAAAGACAAC -> AAAAGACAACT
AAAAGACAACT -> AAAGACAACTC
AAAGACAACTC -> AAGACAACTCT
AAGACAACTCT -> AGACAACTCTC
AGACAACTCTC -> GACAACTCTCA
GACAACTCTCA -> ACAACTCTCAT
ACAACTCTCAT -> CAACTCTCATT
CAACTCTCATT -> AACTCTCATTT
AACTCTCATTT -> ACTCTCATTTT
ACTCTCATTTT -> CTCTCATTTTG
CTCTCATTTTG -> TCTCATTTTGA
TCTCATTTTGA -> CTCATTTTGAA
CTCATTTTGAA -> TCATTTTGAAA
TCATTTTGAAA -> CATTTTGAAAG
CATTTTGAAAG -> ATTTTGAAAGT
ATTTTGAAAGT -> TTTTGAAAGTG
TTTTGAAAGTG -> TTTGAAAGTGC
TTTGAAAGTGC -> TTGAAAGTGCC
TTGAAAGTGCC -> TGAAAGTGCCA
TGAAAGTGCCA -> GAAAGTGCCAT
GAAAGTGCCAT -> AAAGTGCCATC
AAAGTGCCATC -> AAGTGCCATCC
AAGTGCCATCC -> AGTGCCATCCA
AGTGCCATCCA -> GTGCCATCCAC
GTGCCATCCAC -> TGCCATCCACC
TGCCATCCACC -> GCCATCCACCA
GCCATCCACCA -> CCATCCACCAT
CCATCCACCAT -> CATCCACCATG
CATCCACCATG -> ATCCACCATGA
ATCCACCATGA -> TCCACCATGAA
TCCACCATGAA -> CCACCATGAAG
CCACCATGAAG -> CACCATGAAGC
CACCATGAAGC -> ACCATGAAGCT
ACCATGAAGCT -> CCATGAAGCTG
CCATGAAGCTG -> CATGAAGCTGT
CATGAAGCTGT -> ATGAAGCTGTG
ATGAAGCTGTG -> TGAAGCTGTGA
TGAAGCTGTGA -> GAAGCTGTGAG
GAAGCTGTGAG -> AAGCTGTGAGT
AAGCTGTGAGT -> AGCTGTGAGTA
AGCTGTGAGTA -> GCTGTGAGTAC
GCTGTGAGTAC -> CTGTGAGTACG
CTGTGAGTACG -> TGTGAGTACGC
TGTGAGTACGC -> GTGAGTACGCG
GTGAGTACGCG -> TGAGTACGCGT
TGAGTACGCGT -> GAGTACGCGTC
GAGTACGCGTC -> AGTACGCGTCC
AGTACGCGTCC -> GTACGCGTCCC
GTACGCGTCCC -> TACGCGTCCCG
TACGCGTCCCG -> ACGCGTCCCGA
ACGCGTCCCGA -> CGCGTCCCGAA
CGCGTCCCGAA -> GCGTCCCGAAG
GCGTCCCGAAG -> CGTCCCGAAGC
CGTCCCGAAGC -> GTCCCGAAGCA
GTCCCGAAGCA -> TCCCGAAGCAG
TCCCGAAGCAG -> CCCGAAGCAGT
CCCGAAGCAGT -> CCGAAGCAGTC
CCGAAGCAGTC -> CGAAGCAGTCC
CGAAGCAGTCC -> GAAGCAGTCCG
GAAGCAGTCCG -> AAGCAGTCCGA
AAGCAGTCCGA -> AGCAGTCCGAC
AGCAGTCCGAC -> GCAGTCCGACA
GCAGTCCGACA -> CAGTCCGACAA
CAGTCCGACAA -> AGTCCGACAAC
AGTCCGACAAC -> GTCCGACAACC
GTCCGACAACC -> TCCGACAACCA
TCCGACAACCA -> CCGACAACCAT
CCGACAACCAT -> CGACAACCATA
CGACAACCATA -> GACAACCATAA
GACAACCATAA -> ACAACCATAAT
ACAACCATAAT -> CAACCATAATA
CAACCATAATA -> AACCATAATAA
AACCATAATAA -> ACCATAATAAC
ACCATAATAAC -> CCATAATAACC
CCATAATAACC -> CATAATAACCG
CATAATAACCG -> ATAATAACCGG
ATAATAACCGG -> TAATAACCGGC
TAATAACCGGC -> AATAACCGGCG
AATAACCGGCG -> ATAACCGGCGA
ATAACCGGCGA -> TAACCGGCGAT
TAACCGGCGAT -> AACCGGCGATG
AACCGGCGATG -> ACCGGCGATGT
ACCGGCGATGT -> CCGGCGATGTA
CCGGCGATGTA -> CGGCGATGTAG
CGGCGATGTAG -> GGCGATGTAGT
GGCGATGTAGT -> GCGATGTAGTT
GCGATGTAGTT -> CGATGTAGTTC
CGATGTAGTTC -> GATGTAGTTCA
GATGTAGTTCA -> ATGTAGTTCAC
ATGTAGTTCAC -> TGTAGTTCACC
TGTAGTTCACC -> GTAGTTCACCA
GTAGTTCACCA -> TAGTTCACCAG
TAGTTCACCAG -> AGTTCACCAGA
AGTTCACCAGA -> GTTCACCAGAG
GTTCACCAGAG -> TTCACCAGAGC
TTCACCAGAGC -> TCACCAGAGCC
TCACCAGAGCC -> CACCAGAGCCT
CACCAGAGCCT -> ACCAGAGCCTT
ACCAGAGCCTT -> CCAGAGCCTTG
CCAGAGCCTTG -> CAGAGCCTTGA
CAGAGCCTTGA -> AGAGCCTTGAG
AGAGCCTTGAG -> GAGCCTTGAGG
GAGCCTTGAGG -> AGCCTTGAGGG
AGCCTTGAGGG -> GCCTTGAGGGG
GCCTTGAGGGG -> CCTTGAGGGGT
CCTTGAGGGGT -> CTTGAGGGGTT
CTTGAGGGGTT -> TTGAGGGGTTA
TTGAGGGGTTA -> TGAGGGGTTAG
TGAGGGGTTAG -> GAGGGGTTAGG
GAGGGGTTAGG -> AGGGGTTAGGC
AGGGGTTAGGC -> GGGGTTAGGCT
GGGGTTAGGCT -> GGGTTAGGCTC
GGGTTAGGCTC -> GGTTAGGCTCC
GGTTAGGCTCC -> GTTAGGCTCCG
GTTAGGCTCCG -> TTAGGCTCCGT
TTAGGCTCCGT -> TAGGCTCCGTA
TAGGCTCCGTA -> AGGCTCCGTAC
AGGCTCCGTAC -> GGCTCCGTACT
GGCTCCGTACT -> GCTCCGTACTG
GCTCCGTACTG -> CTCCGTACTGT
CTCCGTACTGT -> TCCGTACTGTC
TCCGTACTGTC -> CCGTACTGTCA
CCGTACTGTCA -> CGTACTGTCAG
CGTACTGTCAG -> GTACTGTCAGA
GTACTGTCAGA -> TACTGTCAGAC
TACTGTCAGAC -> ACTGTCAGACA
ACTGTCAGACA -> CTGTCAGACAG
CTGTCAGACAG -> TGTCAGACAGG
TGTCAGACAGG -> GTCAGACAGGA
GTCAGACAGGA -> TCAGACAGGAT
TCAGACAGGAT -> CAGACAGGATG
CAGACAGGATG -> AGACAGGATGG
AGACAGGATGG -> GACAGGATGGG
GACAGGATGGG -> ACAGGATGGGC
ACAGGATGGGC -> CAGGATGGGCC
CAGGATGGGCC -> AGGATGGGCCG
AGGATGGGCCG -> GGATGGGCCGT
GGATGGGCCGT -> GATGGGCCGTC
GATGGGCCGTC -> ATGGGCCGTCT
ATGGGCCGTCT -> TGGGCCGTCTG
TGGGCCGTCTG -> GGGCCGTCTGC
GGGCCGTCTGC -> GGCCGTCTGCC
GGCCGTCTGCC -> GCCGTCTGCCC
GCCGTCTGCCC -> CCGTCTGCCCT
CCGTCTGCCCT -> CGTCTGCCCTG
CGTCTGCCCTG -> GTCTGCCCTGT
GTCTGCCCTGT -> TCTGCCCTGTT
TCTGCCCTGTT -> CTGCCCTGTTC
CTGCCCTGTTC -> TGCCCTGTTCT
TGCCCTGTTCT -> GCCCTGTTCTC
GCCCTGTTCTC -> CCCTGTTCTCG
CCCTGTTCTCG -> CCTGTTCTCGG
CCTGTTCTCGG -> CTGTTCTCGGA
CTGTTCTCGGA -> TGTTCTCGGAG
TGTTCTCGGAG -> GTTCTCGGAGA
GTTCTCGGAGA -> TTCTCGGAGAC
TTCTCGGAGAC -> TCTCGGAGACT
TCTCGGAGACT -> CTCGGAGACTT
CTCGGAGACTT -> TCGGAGACTTA
TCGGAGACTTA -> CGGAGACTTAA
CGGAGACTTAA -> GGAGACTTAAA
GGAGACTTAAA -> GAGACTTAAAC
GAGACTTAAAC -> AGACTTAAACC
AGACTTAAACC -> GACTTAAACCC
GACTTAAACCC -> ACTTAAACCCG
ACTTAAACCCG -> CTTAAACCCGA
CTTAAACCCGA -> TTAAACCCGAG
TTAAACCCGAG -> TAAACCCGAGA
TAAACCCGAGA -> AAACCCGAGAC
AAACCCGAGAC -> AACCCGAGACT
AACCCGAGACT -> ACCCGAGACTC
ACCCGAGACTC -> CCCGAGACTCG
CCCGAGACTCG -> CCGAGACTCGA
CCGAGACTCGA -> CGAGACTCGAC
CGAGACTCGAC -> GAGACTCGACT
GAGACTCGACT -> AGACTCGACTC
AGACTCGACTC -> GACTCGACTCA
GACTCGACTCA -> ACTCGACTCAA
ACTCGACTCAA -> CTCGACTCAAG
CTCGACTCAAG -> TCGACTCAAGT
TCGACTCAAGT -> CGACTCAAGTA
CGACTCAAGTA -> GACTCAAGTAA
GACTCAAGTAA -> ACTCAAGTAAG
ACTCAAGTAAG -> CTCAAGTAAGG
CTCAAGTAAGG -> TCAAGTAAGGT
TCAAGTAAGGT -> CAAGTAAGGTG
CAAGTAAGGTG -> AAGTAAGGTGA
AAGTAAGGTGA -> AGTAAGGTGAG
AGTAAGGTGAG -> GTAAGGTGAGG
GTAAGGTGAGG -> TAAGGTGAGGA
TAAGGTGAGGA -> AAGGTGAGGAC
AAGGTGAGGAC -> AGGTGAGGACG
AGGTGAGGACG -> GGTGAGGACGG
GGTGAGGACGG -> GTGAGGACGGA
GTGAGGACGGA -> TGAGGACGGAG
TGAGGACGGAG -> GAGGACGGAGC
GAGGACGGAGC -> AGGACGGAGCG
AGGACGGAGCG -> GGACGGAGCGC
GGACGGAGCGC -> GACGGAGCGCA
GACGGAGCGCA -> ACGGAGCGCAA
ACGGAGCGCAA -> CGGAGCGCAAG
CGGAGCGCAAG -> GGAGCGCAAGG
GGAGCGCAAGG -> GAGCGCAAGGC
GAGCGCAAGGC -> AGCGCAAGGCG
AGCGCAAGGCG -> GCGCAAGGCGC
GCGCAAGGCGC -> CGCAAGGCGCG
CGCAAGGCGCG -> GCAAGGCGCGT
GCAAGGCGCGT -> CAAGGCGCGTA
CAAGGCGCGTA -> AAGGCGCGTAT
AAGGCGCGTAT -> AGGCGCGTATT
AGGCGCGTATT -> GGCGCGTATTG
GGCGCGTATTG -> GCGCGTATTGC
GCGCGTATTGC -> CGCGTATTGCC
CGCGTATTGCC -> GCGTATTGCCT
GCGTATTGCCT -> CGTATTGCCTC
CGTATTGCCTC -> GTATTGCCTCT
GTATTGCCTCT -> TATTGCCTCTA
TATTGCCTCTA -> ATTGCCTCTAA
ATTGCCTCTAA -> TTGCCTCTAAC
TTGCCTCTAAC -> TGCCTCTAACA
TGCCTCTAACA -> GCCTCTAACAA
GCCTCTAACAA -> CCTCTAACAAT
CCTCTAACAAT -> CTCTAACAATG
CTCTAACAATG -> TCTAACAATGG
TCTAACAATGG -> CTAACAATGGT
CTAACAATGGT -> TAACAATGGTA
TAACAATGGTA -> AACAATGGTAG
AACAATGGTAG -> ACAATGGTAGG
ACAATGGTAGG -> CAATGGTAGGC
CAATGGTAGGC -> AATGGTAGGCT
AATGGTAGGCT -> ATGGTAGGCTC
ATGGTAGGCTC -> TGGTAGGCTCG
TGGTAGGCTCG -> GGTAGGCTCGT
GGTAGGCTCGT -> GTAGGCTCGTT
GTAGGCTCGTT -> TAGGCTCGTTA
TAGGCTCGTTA -> AGGCTCGTTAG
AGGCTCGTTAG -> GGCTCGTTAGT
GGCTCGTTAGT -> GCTCGTTAGTC
GCTCGTTAGTC -> CTCGTTAGTCT
CTCGTTAGTCT -> TCGTTAGTCTG
TCGTTAGTCTG -> CGTTAGTCTGT
CGTTAGTCTGT -> GTTAGTCTGTA
GTTAGTCTGTA -> TTAGTCTGTAC
TTAGTCTGTAC -> TAGTCTGTACC
TAGTCTGTACC -> AGTCTGTACCG
AGTCTGTACCG -> GTCTGTACCGC
GTCTGTACCGC -> TCTGTACCGCT
TCTGTACCGCT -> CTGTACCGCTT
CTGTACCGCTT -> TGTACCGCTTA
TGTACCGCTTA -> GTACCGCTTAG
GTACCGCTTAG -> TACCGCTTAGG
TACCGCTTAGG -> ACCGCTTAGGC
ACCGCTTAGGC -> CCGCTTAGGCA
CCGCTTAGGCA -> CGCTTAGGCAC
CGCTTAGGCAC -> GCTTAGGCACG
GCTTAGGCACG -> CTTAGGCACGT
CTTAGGCACGT -> TTAGGCACGTA
TTAGGCACGTA -> TAGGCACGTAT
TAGGCACGTAT -> AGGCACGTATC
AGGCACGTATC -> GGCACGTATCA
GGCACGTATCA -> GCACGTATCAT
GCACGTATCAT -> CACGTATCATC
CACGTATCATC -> ACGTATCATCC
ACGTATCATCC -> CGTATCATCCA
CGTATCATCCA -> GTATCATCCAG
GTATCATCCAG -> TATCATCCAGC
TATCATCCAGC -> ATCATCCAGCC
ATCATCCAGCC -> TCATCCAGCCA
TCATCCAGCCA -> CATCCAGCCAG
CATCCAGCCAG -> ATCCAGCCAGA
ATCCAGCCAGA -> TCCAGCCAGAA
TCCAGCCAGAA -> CCAGCCAGAAA
CCAGCCAGAAA -> CAGCCAGAAAC
CAGCCAGAAAC -> AGCCAGAAACC
AGCCAGAAACC -> GCCAGAAACCG
GCCAGAAACCG -> CCAGAAACCGG
CCAGAAACCGG -> CAGAAACCGGT
CAGAAACCGGT -> AGAAACCGGTA
AGAAACCGGTA -> GAAACCGGTAT
GAAACCGGTAT -> AAACCGGTATG
AAACCGGTATG -> AACCGGTATGT
AACCGGTATGT -> ACCGGTATGTA
ACCGGTATGTA -> CCGGTATGTAG
CCGGTATGTAG -> CGGTATGTAGA
CGGTATGTAGA -> GGTATGTAGAG
GGTATGTAGAG -> GTATGTAGAGG
GTATGTAGAGG -> TATGTAGAGGC
TATGTAGAGGC -> ATGTAGAGGCT
ATGTAGAGGCT -> TGTAGAGGCTC
TGTAGAGGCTC -> GTAGAGGCTCT
GTAGAGGCTCT -> TAGAGGCTCTA
TAGAGGCTCTA -> AGAGGCTCTAG
AGAGGCTCTAG -> GAGGCTCTAGT
GAGGCTCTAGT -> AGGCTCTAGTC
AGGCTCTAGTC -> GGCTCTAGTCC
GGCTCTAGTCC -> GCTCTAGTCCG
GCTCTAGTCCG -> CTCTAGTCCGT
CTCTAGTCCGT -> TCTAGTCCGTA
TCTAGTCCGTA -> CTAGTCCGTAG
CTAGTCCGTAG -> TAGTCCGTAGC
TAGTCCGTAGC -> AGTCCGTAGCG
AGTCCGTAGCG -> GTCCGTAGCGT
GTCCGTAGCGT -> TCCGTAGCGTG
TCCGTAGCGTG -> CCGTAGCGTGT
CCGTAGCGTGT -> CGTAGCGTGTG
CGTAGCGTGTG -> GTAGCGTGTGA
GTAGCGTGTGA -> TAGCGTGTGAG
TAGCGTGTGAG -> AGCGTGTGAGT
AGCGTGTGAGT -> GCGTGTGAGTC
GCGTGTGAGTC -> CGTGTGAGTCC
CGTGTGAGTCC -> GTGTGAGTCCT
GTGTGAGTCCT -> TGTGAGTCCTT
TGTGAGTCCTT -> GTGAGTCCTTC
GTGAGTCCTTC -> TGAGTCCTTCC
TGAGTCCTTCC -> GAGTCCTTCCG
GAGTCCTTCCG -> AGTCCTTCCGC
AGTCCTTCCGC -> GTCCTTCCGCC
GTCCTTCCGCC -> TCCTTCCGCCA
TCCTTCCGCCA -> CCTTCCGCCAA
CCTTCCGCCAA -> CTTCCGCCAAC
CTTCCGCCAAC -> TTCCGCCAACG
TTCCGCCAACG -> TCCGCCAACGG
TCCGCCAACGG -> CCGCCAACGGA
CCGCCAACGGA -> CGCCAACGGAC
CGCCAACGGAC -> GCCAACGGACC
GCCAACGGACC -> CCAACGGACCC
CCAACGGACCC -> CAACGGACCCT
CAACGGACCCT -> AACGGACCCTT
AACGGACCCTT -> ACGGACCCTTG
ACGGACCCTTG -> CGGACCCTTGT
CGGACCCTTGT -> GGACCCTTGTC
GGACCCTTGTC -> GACCCTTGTCG
GACCCTTGTCG -> ACCCTTGTCGG
ACCCTTGTCGG -> CCCTTGTCGGC
CCCTTGTCGGC -> CCTTGTCGGCC
CCTTGTCGGCC -> CTTGTCGGCCT
CTTGTCGGCCT -> TTGTCGGCCTC
TTGTCGGCCTC -> TGTCGGCCTCG
TGTCGGCCTCG -> GTCGGCCTCGC
GTCGGCCTCGC -> TCGGCCTCGCT
TCGGCCTCGCT -> CGGCCTCGCTG
CGGCCTCGCTG -> GGCCTCGCTGC
GGCCTCGCTGC -> GCCTCGCTGCA
GCCTCGCTGCA -> CCTCGCTGCAG
CCTCGCTGCAG -> CTCGCTGCAGG
CTCGCTGCAGG -> TCGCTGCAGGC
TCGCTGCAGGC -> CGCTGCAGGCG
CGCTGCAGGCG -> GCTGCAGGCGA
GCTGCAGGCGA -> CTGCAGGCGAA
CTGCAGGCGAA -> TGCAGGCGAAG
TGCAGGCGAAG -> GCAGGCGAAGC
GCAGGCGAAGC -> CAGGCGAAGCC
CAGGCGAAGCC -> AGGCGAAGCCC
AGGCGAAGCCC -> GGCGAAGCCCG
GGCGAAGCCCG -> GCGAAGCCCGT
GCGAAGCCCGT -> CGAAGCCCGTA
CGAAGCCCGTA -> GAAGCCCGTAA
GAAGCCCGTAA -> AAGCCCGTAAG
AAGCCCGTAAG -> AGCCCGTAAGG
AGCCCGTAAGG -> GCCCGTAAGGT
GCCCGTAAGGT -> CCCGTAAGGTC
CCCGTAAGGTC -> CCGTAAGGTCT
CCGTAAGGTCT -> CGTAAGGTCTA
CGTAAGGTCTA -> GTAAGGTCTAG
GTAAGGTCTAG -> TAAGGTCTAGG
TAAGGTCTAGG -> AAGGTCTAGGA
AAGGTCTAGGA -> AGGTCTAGGAC
AGGTCTAGGAC -> GGTCTAGGACT
GGTCTAGGACT -> GTCTAGGACTA
GTCTAGGACTA -> TCTAGGACTAT
TCTAGGACTAT -> CTAGGACTATG
CTAGGACTATG -> TAGGACTATGG
TAGGACTATGG -> AGGACTATGGA
AGGACTATGGA -> GGACTATGGAA
GGACTATGGAA -> GACTATGGAAA
GACTATGGAAA -> ACTATGGAAAT
ACTATGGAAAT -> CTATGGAAATC
CTATGGAAATC -> TATGGAAATCC
TATGGAAATCC -> ATGGAAATCCG
ATGGAAATCCG -> TGGAAATCCGG
TGGAAATCCGG -> GGAAATCCGGC
GGAAATCCGGC -> GAAATCCGGCT
GAAATCCGGCT -> AAATCCGGCTG
AAATCCGGCTG -> AATCCGGCTGC
AATCCGGCTGC -> ATCCGGCTGCA
ATCCGGCTGCA -> TCCGGCTGCAC
TCCGGCTGCAC -> CCGGCTGCACA
CCGGCTGCACA -> CGGCTGCACAG
CGGCTGCACAG -> GGCTGCACAGC
GGCTGCACAGC -> GCTGCACAGCT
GCTGCACAGCT -> CTGCACAGCTC
CTGCACAGCTC -> TGCACAGCTCT
TGCACAGCTCT -> GCACAGCTCTT
GCACAGCTCTT -> CACAGCTCTTT
CACAGCTCTTT -> ACAGCTCTTTA
ACAGCTCTTTA -> CAGCTCTTTAC
CAGCTCTTTAC -> AGCTCTTTACT
AGCTCTTTACT -> GCTCTTTACTA
GCTCTTTACTA -> CTCTTTACTAA
CTCTTTACTAA -> TCTTTACTAAC
TCTTTACTAAC -> CTTTACTAACG
CTTTACTAACG -> TTTACTAACGG
TTTACTAACGG -> TTACTAACGGA
TTACTAACGGA -> TACTAACGGAT
TACTAACGGAT -> ACTAACGGATT
ACTAACGGATT -> CTAACGGATTG
CTAACGGATTG -> TAACGGATTGG
TAACGGATTGG -> AACGGATTGGT
AACGGATTGGT -> ACGGATTGGTA
ACGGATTGGTA -> CGGATTGGTAC
CGGATTGGTAC -> GGATTGGTACG
GGATTGGTACG -> GATTGGTACGT
GATTGGTACGT -> ATTGGTACGTG
ATTGGTACGTG -> TTGGTACGTGA
TTGGTACGTGA -> TGGTACGTGAC
TGGTACGTGAC -> GGTACGTGACG
GGTACGTGACG -> GTACGTGACGC
GTACGTGACGC -> TACGTGACGCA
TACGTGACGCA -> ACGTGACGCAT
ACGTGACGCAT -> CGTGACGCATA
CGTGACGCATA -> GTGACGCATAT
GTGACGCATAT -> TGACGCATATG
TGACGCATATG -> GACGCATATGG
GACGCATATGG -> ACGCATATGGG
ACGCATATGGG -> CGCATATGGGC
CGCATATGGGC -> GCATATGGGCA
GCATATGGGCA -> CATATGGGCAA
CATATGGGCAA -> ATATGGGCAAC
ATATGGGCAAC -> TATGGGCAACC
TATGGGCAACC -> ATGGGCAACCG
ATGGGCAACCG -> TGGGCAACCGC
TGGGCAACCGC -> GGGCAACCGCG
GGGCAACCGCG -> GGCAACCGCGA
GGCAACCGCGA -> GCAACCGCGAG
GCAACCGCGAG -> CAACCGCGAGT
CAACCGCGAGT -> AACCGCGAGTC
AACCGCGAGTC -> ACCGCGAGTCT
ACCGCGAGTCT -> CCGCGAGTCTT
CCGCGAGTCTT -> CGCGAGTCTTC
CGCGAGTCTTC -> GCGAGTCTTCC
GCGAGTCTTCC -> CGAGTCTTCCT
CGAGTCTTCCT -> GAGTCTTCCTA
GAGTCTTCCTA -> AGTCTTCCTAC
AGTCTTCCTAC -> GTCTTCCTACT
GTCTTCCTACT -> TCTTCCTACTC
TCTTCCTACTC -> CTTCCTACTCA
CTTCCTACTCA -> TTCCTACTCAG
TTCCTACTCAG -> TCCTACTCAGA
TCCTACTCAGA -> CCTACTCAGAC
CCTACTCAGAC -> CTACTCAGACG
CTACTCAGACG -> TACTCAGACGT
TACTCAGACGT -> ACTCAGACGTT
ACTCAGACGTT -> CTCAGACGTTA
CTCAGACGTTA -> TCAGACGTTAG
TCAGACGTTAG -> CAGACGTTAGC
CAGACGTTAGC -> AGACGTTAGCT
AGACGTTAGCT -> GACGTTAGCTG
GACGTTAGCTG -> ACGTTAGCTGT
ACGTTAGCTGT -> CGTTAGCTGTG
CGTTAGCTGTG -> GTTAGCTGTGG
GTTAGCTGTGG -> TTAGCTGTGGA
TTAGCTGTGGA -> TAGCTGTGGAA
TAGCTGTGGAA -> AGCTGTGGAAT
AGCTGTGGAAT -> GCTGTGGAATA
GCTGTGGAATA -> CTGTGGAATAG
CTGTGGAATAG -> TGTGGAATAGC
TGTGGAATAGC -> GTGGAATAGCG
GTGGAATAGCG -> TGGAATAGCGC
TGGAATAGCGC -> GGAATAGCGCA
GGAATAGCGCA -> GAATAGCGCAT
GAATAGCGCAT -> AATAGCGCATT
AATAGCGCATT -> ATAGCGCATTA
ATAGCGCATTA -> TAGCGCATTAG
TAGCGCATTAG -> AGCGCATTAGG
AGCGCATTAGG -> GCGCATTAGGT
GCGCATTAGGT -> CGCATTAGGTC
CGCATTAGGTC -> GCATTAGGTCA
GCATTAGGTCA -> CATTAGGTCAG
CATTAGGTCAG -> ATTAGGTCAGT
ATTAGGTCAGT -> TTAGGTCAGTC
TTAGGTCAGTC -> TAGGTCAGTCA
TAGGTCAGTCA -> AGGTCAGTCAG
AGGTCAGTCAG -> GGTCAGTCAGC
GGTCAGTCAGC -> GTCAGTCAGCA
GTCAGTCAGCA -> TCAGTCAGCAC
TCAGTCAGCAC -> CAGTCAGCACC
CAGTCAGCACC -> AGTCAGCACCA
AGTCAGCACCA -> GTCAGCACCAA
GTCAGCACCAA -> TCAGCACCAAG
TCAGCACCAAG -> CAGCACCAAGG
CAGCACCAAGG -> AGCACCAAGGT
AGCACCAAGGT -> GCACCAAGGTT
GCACCAAGGTT -> CACCAAGGTTA
CACCAAGGTTA -> ACCAAGGTTAT
ACCAAGGTTAT -> CCAAGGTTATT
CCAAGGTTATT -> CAAGGTTATTG
CAAGGTTATTG -> AAGGTTATTGA
AAGGTTATTGA -> AGGTTATTGAT
AGGTTATTGAT -> GGTTATTGATA
GGTTATTGATA -> GTTATTGATAC
GTTATTGATAC -> TTATTGATACA
TTATTGATACA -> TATTGATACAG
TATTGATACAG -> ATTGATACAGC
ATTGATACAGC -> TTGATACAGCC
TTGATACAGCC -> TGATACAGCCG
TGATACAGCCG -> GATACAGCCGG
GATACAGCCGG -> ATACAGCCGGT
ATACAGCCGGT -> TACAGCCGGTA
TACAGCCGGTA -> ACAGCCGGTAC
ACAGCCGGTAC -> CAGCCGGTACC
CAGCCGGTACC -> AGCCGGTACCT
AGCCGGTACCT -> GCCGGTACCTA
GCCGGTACCTA -> CCGGTACCTAC
CCGGTACCTAC -> CGGTACCTACT
CGGTACCTACT -> GGTACCTACTG
GGTACCTACTG -> GTACCTACTGA
GTACCTACTGA -> TACCTACTGAC
TACCTACTGAC -> ACCTACTGACT
ACCTACTGACT -> CCTACTGACTA
CCTACTGACTA -> CTACTGACTAT
CTACTGACTAT -> TACTGACTATA
TACTGACTATA -> ACTGACTATAC
ACTGACTATAC -> CTGACTATACT
CTGACTATACT -> TGACTATACTA
TGACTATACTA -> GACTATACTAA
GACTATACTAA -> ACTATACTAAG
ACTATACTAAG -> CTATACTAAGA
CTATACTAAGA -> TATACTAAGAT
TATACTAAGAT -> ATACTAAGATG
ATACTAAGATG -> TACTAAGATGC
TACTAAGATGC -> ACTAAGATGCG
ACTAAGATGCG -> CTAAGATGCGC
CTAAGATGCGC -> TAAGATGCGCT
TAAGATGCGCT -> AAGATGCGCTG
AAGATGCGCTG -> AGATGCGCTGA
AGATGCGCTGA -> GATGCGCTGAT
GATGCGCTGAT -> ATGCGCTGATC
ATGCGCTGATC -> TGCGCTGATCC
TGCGCTGATCC -> GCGCTGATCCC
GCGCTGATCCC -> CGCTGATCCCT
CGCTGATCCCT -> GCTGATCCCTA
GCTGATCCCTA -> CTGATCCCTAC
CTGATCCCTAC -> TGATCCCTACA
TGATCCCTACA -> GATCCCTACAA
GATCCCTACAA -> ATCCCTACAAG
ATCCCTACAAG -> TCCCTACAAGT
TCCCTACAAGT -> CCCTACAAGTT
CCCTACAAGTT -> CCTACAAGTTG
CCTACAAGTTG -> CTACAAGTTGG
CTACAAGTTGG -> TACAAGTTGGT
TACAAGTTGGT -> ACAAGTTGGTG
ACAAGTTGGTG -> CAAGTTGGTGT
CAAGTTGGTGT -> AAGTTGGTGTA
AAGTTGGTGTA -> AGTTGGTGTAC
AGTTGGTGTAC -> GTTGGTGTACC
GTTGGTGTACC -> TTGGTGTACCA
TTGGTGTACCA -> TGGTGTACCAA
TGGTGTACCAA -> GGTGTACCAAG
GGTGTACCAAG -> GTGTACCAAGT
GTGTACCAAGT -> TGTACCAAGTG
TGTACCAAGTG -> GTACCAAGTGC
GTACCAAGTGC -> TACCAAGTGCC
TACCAAGTGCC -> ACCAAGTGCCT
ACCAAGTGCCT -> CCAAGTGCCTG
CCAAGTGCCTG -> CAAGTGCCTGG
CAAGTGCCTGG -> AAGTGCCTGGG
AAGTGCCTGGG -> AGTGCCTGGGG
AGTGCCTGGGG -> GTGCCTGGGGT
GTGCCTGGGGT -> TGCCTGGGGTT
TGCCTGGGGTT -> GCCTGGGGTTT
GCCTGGGGTTT -> CCTGGGGTTTG
CCTGGGGTTTG -> CTGGGGTTTGC
CTGGGGTTTGC -> TGGGGTTTGCC
TGGGGTTTGCC -> GGGGTTTGCCT
GGGGTTTGCCT -> GGGTTTGCCTA
GGGTTTGCCTA -> GGTTTGCCTAA
GGTTTGCCTAA -> GTTTGCCTAAA
GTTTGCCTAAA -> TTTGCCTAAAC
TTTGCCTAAAC -> TTGCCTAAACC
TTGCCTAAACC -> TGCCTAAACCG
TGCCTAAACCG -> GCCTAAACCGG
GCCTAAACCGG -> CCTAAACCGGG
CCTAAACCGGG -> CTAAACCGGGT
CTAAACCGGGT -> TAAACCGGGTA
TAAACCGGGTA -> AAACCGGGTAT
AAACCGGGTAT -> AACCGGGTATC
AACCGGGTATC -> ACCGGGTATCC
ACCGGGTATCC -> CCGGGTATCCT
CCGGGTATCCT -> CGGGTATCCTG
CGGGTATCCTG -> GGGTATCCTGA
GGGTATCCTGA -> GGTATCCTGAG
GGTATCCTGAG -> GTATCCTGAGT
GTATCCTGAGT -> TATCCTGAGTG
TATCCTGAGTG -> ATCCTGAGTGG
ATCCTGAGTGG -> TCCTGAGTGGT
TCCTGAGTGGT -> CCTGAGTGGTT
CCTGAGTGGTT -> CTGAGTGGTTA
CTGAGTGGTTA -> TGAGTGGTTAC
AGTGGTTACCA -> GTGGTTACCAG
GTGGTTACCAG -> TGGTTACCAGT
TGGTTACCAGT -> GGTTACCAGTT
GGTTACCAGTT -> GTTACCAGTTA
GTTACCAGTTA -> TTACCAGTTAA
TTACCAGTTAA -> TACCAGTTAAT
TACCAGTTAAT -> ACCAGTTAATA
ACCAGTTAATA -> CCAGTTAATAC
CCAGTTAATAC -> CAGTTAATACA
CAGTTAATACA -> AGTTAATACAC
AGTTAATACAC -> GTTAATACACA
GTTAATACACA -> TTAATACACAA
TTAATACACAA -> TAATACACAAC
TAATACACAAC -> AATACACAACC
AATACACAACC -> ATACACAACCA
ATACACAACCA -> TACACAACCAT
TACACAACCAT -> ACACAACCATC
ACACAACCATC -> CACAACCATCT
CACAACCATCT -> ACAACCATCTA
ACAACCATCTA -> CAACCATCTAT
CAACCATCTAT -> AACCATCTATT
AACCATCTATT -> ACCATCTATTC
ACCATCTATTC -> CCATCTATTCG
CCATCTATTCG -> CATCTATTCGC
CATCTATTCGC -> ATCTATTCGCC
ATCTATTCGCC -> TCTATTCGCCT
TCTATTCGCCT -> CTATTCGCCTC
CTATTCGCCTC -> TATTCGCCTCA
TATTCGCCTCA -> ATTCGCCTCAC
ATTCGCCTCAC -> TTCGCCTCACC
TTCGCCTCACC -> TCGCCTCACCA
TCGCCTCACCA -> CGCCTCACCAA
CGCCTCACCAA -> GCCTCACCAAA
GCCTCACCAAA -> CCTCACCAAAG
CCTCACCAAAG -> CTCACCAAAGT
CTCACCAAAGT -> TCACCAAAGTG
TCACCAAAGTG -> CACCAAAGTGA
CACCAAAGTGA -> ACCAAAGTGAA
ACCAAAGTGAA -> CCAAAGTGAAT
CCAAAGTGAAT -> CAAAGTGAATG
CAAAGTGAATG -> AAAGTGAATGA
AAAGTGAATGA -> AAGTGAATGAT
AAGTGAATGAT -> AGTGAATGATA
AGTGAATGATA -> GTGAATGATAG
GTGAATGATAG -> TGAATGATAGG
TGAATGATAGG -> GAATGATAGGT
GAATGATAGGT -> AATGATAGGTG
AATGATAGGTG -> ATGATAGGTGC
ATGATAGGTGC -> TGATAGGTGCA
TGATAGGTGCA -> GATAGGTGCAG
GATAGGTGCAG -> ATAGGTGCAGT
ATAGGTGCAGT -> TAGGTGCAGTT
TAGGTGCAGTT -> AGGTGCAGTTT
AGGTGCAGTTT -> GGTGCAGTTTT
GGTGCAGTTTT -> GTGCAGTTTTT
GTGCAGTTTTT -> TGCAGTTTTTA
TGCAGTTTTTA -> GCAGTTTTTAA
GCAGTTTTTAA -> CAGTTTTTAAG
CAGTTTTTAAG -> AGTTTTTAAGT
AGTTTTTAAGT -> GTTTTTAAGTG
GTTTTTAAGTG -> TTTTTAAGTGC
TTTTTAAGTGC -> TTTTAAGTGCC
TTTTAAGTGCC -> TTTAAGTGCCG
TTTAAGTGCCG -> TTAAGTGCCGA
TTAAGTGCCGA -> TAAGTGCCGAC
TAAGTGCCGAC -> AAGTGCCGACA
AAGTGCCGACA -> AGTGCCGACAG
AGTGCCGACAG -> GTGCCGACAGT
GTGCCGACAGT -> TGCCGACAGTC
TGCCGACAGTC -> GCCGACAGTCT
GCCGACAGTCT -> CCGACAGTCTC
CCGACAGTCTC -> CGACAGTCTCT
CGACAGTCTCT -> GACAGTCTCTC
GACAGTCTCTC -> ACAGTCTCTCT
ACAGTCTCTCT -> CAGTCTCTCTC
CAGTCTCTCTC -> AGTCTCTCTCG
AGTCTCTCTCG -> GTCTCTCTCGA
GTCTCTCTCGA -> TCTCTCTCGAT
TCTCTCTCGAT -> CTCTCTCGATA
CTCTCTCGATA -> TCTCTCGATAT
TCTCTCGATAT -> CTCTCGATATA
CTCTCGATATA -> TCTCGATATAA
TCTCGATATAA -> CTCGATATAAA
CTCGATATAAA -> TCGATATAAAC
TCGATATAAAC -> CGATATAAACG
CGATATAAACG -> GATATAAACGG
GATATAAACGG -> ATATAAACGGT
ATATAAACGGT -> TATAAACGGTC
TATAAACGGTC -> ATAAACGGTCA
ATAAACGGTCA -> TAAACGGTCAT
TAAACGGTCAT -> AAACGGTCATA
AAACGGTCATA -> AACGGTCATAC
AACGGTCATAC -> ACGGTCATACG
ACGGTCATACG -> CGGTCATACGG
CGGTCATACGG -> GGTCATACGGT
GGTCATACGGT -> GTCATACGGTT
GTCATACGGTT -> TCATACGGTTG
TCATACGGTTG -> CATACGGTTGT
CATACGGTTGT -> ATACGGTTGTA
ATACGGTTGTA -> TACGGTTGTAC
TACGGTTGTAC -> ACGGTTGTACA
ACGGTTGTACA -> CGGTTGTACAT
CGGTTGTACAT -> GGTTGTACATG
GGTTGTACATG -> GTTGTACATGC
GTTGTACATGC -> TTGTACATGCC
TTGTACATGCC -> TGTACATGCCT
TGTACATGCCT -> GTACATGCCTG
GTACATGCCTG -> TACATGCCTGA
TACATGCCTGA -> ACATGCCTGAG
ACATGCCTGAG -> CATGCCTGAGT
CATGCCTGAGT -> ATGCCTGAGTG
ATGCCTGAGTG -> TGCCTGAGTGG
TGCCTGAGTGG -> GCCTGAGTGGG
GCCTGAGTGGG -> CCTGAGTGGGG
CCTGAGTGGGG -> CTGAGTGGGGA
CTGAGTGGGGA -> TGAGTGGGGAT
TGAGTGGGGAT -> GAGTGGGGATA
GAGTGGGGATA -> AGTGGGGATAT
AGTGGGGATAT -> GTGGGGATATC
GTGGGGATATC -> TGGGGATATCT
TGGGGATATCT -> GGGGATATCTT
GGGGATATCTT -> GGGATATCTTG
GGGATATCTTG -> GGATATCTTGC
GGATATCTTGC -> GATATCTTGCT
GATATCTTGCT -> ATATCTTGCTG
ATATCTTGCTG -> TATCTTGCTGG
TATCTTGCTGG -> ATCTTGCTGGT
ATCTTGCTGGT -> TCTTGCTGGTT
TCTTGCTGGTT -> CTTGCTGGTTA
CTTGCTGGTTA -> TTGCTGGTTAG
TTGCTGGTTAG -> TGCTGGTTAGG
TGCTGGTTAGG -> GCTGGTTAGGA
GCTGGTTAGGA -> CTGGTTAGGAC
CTGGTTAGGAC -> TGGTTAGGACA
TGGTTAGGACA -> GGTTAGGACAG
GGTTAGGACAG -> GTTAGGACAGA
GTTAGGACAGA -> TTAGGACAGAG
TTAGGACAGAG -> TAGGACAGAGT
TAGGACAGAGT -> AGGACAGAGTG
AGGACAGAGTG -> GGACAGAGTGC
GGACAGAGTGC -> GACAGAGTGCG
GACAGAGTGCG -> ACAGAGTGCGA
ACAGAGTGCGA -> CAGAGTGCGAC
CAGAGTGCGAC -> AGAGTGCGACT
AGAGTGCGACT -> GAGTGCGACTA
GAGTGCGACTA -> AGTGCGACTAG
AGTGCGACTAG -> GTGCGACTAGA
GTGCGACTAGA -> TGCGACTAGAC
TGCGACTAGAC -> GCGACTAGACC
GCGACTAGACC -> CGACTAGACCT
CGACTAGACCT -> GACTAGACCTC
GACTAGACCTC -> ACTAGACCTCC
ACTAGACCTCC -> CTAGACCTCCC
CTAGACCTCCC -> TAGACCTCCCC
TAGACCTCCCC -> AGACCTCCCCC
AGACCTCCCCC -> GACCTCCCCCC
GACCTCCCCCC -> ACCTCCCCCCG
ACCTCCCCCCG -> CCTCCCCCCGC
CCTCCCCCCGC -> CTCCCCCCGCG
CTCCCCCCGCG -> TCCCCCCGCGC
TCCCCCCGCGC -> CCCCCCGCGCC
CCCCCCGCGCC -> CCCCCGCGCCT
CCCCCGCGCCT -> CCCCGCGCCTC
CCCCGCGCCTC -> CCCGCGCCTCG
CCCGCGCCTCG -> CCGCGCCTCGT
CCGCGCCTCGT -> CGCGCCTCGTT
CGCGCCTCGTT -> GCGCCTCGTTC
GCGCCTCGTTC -> CGCCTCGTTCA
CGCCTCGTTCA -> GCCTCGTTCAA
GCCTCGTTCAA -> CCTCGTTCAAA
CCTCGTTCAAA -> CTCGTTCAAAG
CTCGTTCAAAG -> TCGTTCAAAGG
TCGTTCAAAGG -> CGTTCAAAGGG
CGTTCAAAGGG -> GTTCAAAGGGT
GTTCAAAGGGT -> TTCAAAGGGTA
TTCAAAGGGTA -> TCAAAGGGTAG
TCAAAGGGTAG -> CAAAGGGTAGG
CAAAGGGTAGG -> AAAGGGTAGGT
AAAGGGTAGGT -> AAGGGTAGGTG
AAGGGTAGGTG -> AGGGTAGGTGG
AGGGTAGGTGG -> GGGTAGGTGGA
GGGTAGGTGGA -> GGTAGGTGGAT
GGTAGGTGGAT -> GTAGGTGGATG
GTAGGTGGATG -> TAGGTGGATGT
TAGGTGGATGT -> AGGTGGATGTT
AGGTGGATGTT -> GGTGGATGTTA
GGTGGATGTTA -> GTGGATGTTAC
GTGGATGTTAC -> TGGATGTTACT
TGGATGTTACT -> GGATGTTACTT
GGATGTTACTT -> GATGTTACTTA
GATGTTACTTA -> ATGTTACTTAT
ATGTTACTTAT -> TGTTACTTATC
TGTTACTTATC -> GTTACTTATCC
GTTACTTATCC -> TTACTTATCCG
TTACTTATCCG -> TACTTATCCGA
TACTTATCCGA -> ACTTATCCGAC
ACTTATCCGAC -> CTTATCCGACA
CTTATCCGACA -> TTATCCGACAC
TTATCCGACAC -> TATCCGACACT
TATCCGACACT -> ATCCGACACTT
ATCCGACACTT -> TCCGACACTTT
TCCGACACTTT -> CCGACACTTTA
CCGACACTTTA -> CGACACTTTAC
CGACACTTTAC -> GACACTTTACC
GACACTTTACC -> ACACTTTACCT
ACACTTTACCT -> CACTTTACCTG
CACTTTACCTG -> ACTTTACCTGC
ACTTTACCTGC -> CTTTACCTGCC
CTTTACCTGCC -> TTTACCTGCCT
TTTACCTGCCT -> TTACCTGCCTG
TTACCTGCCTG -> TACCTGCCTGC
TACCTGCCTGC -> ACCTGCCTGCC
ACCTGCCTGCC -> CCTGCCTGCCA
CCTGCCTGCCA -> CTGCCTGCCAT
CTGCCTGCCAT -> TGCCTGCCATA
TGCCTGCCATA -> GCCTGCCATAT
GCCTGCCATAT -> CCTGCCATATC
CCTGCCATATC -> CTGCCATATCT
CTGCCATATCT -> TGCCATATCTA
TGCCATATCTA -> GCCATATCTAA
GCCATATCTAA -> CCATATCTAAT
CCATATCTAAT -> CATATCTAATT
CATATCTAATT -> ATATCTAATTG
ATATCTAATTG -> TATCTAATTGG
TATCTAATTGG -> ATCTAATTGGC
ATCTAATTGGC -> TCTAATTGGCC
TCTAATTGGCC -> CTAATTGGCCG
CTAATTGGCCG -> TAATTGGCCGT
TAATTGGCCGT -> AATTGGCCGTG
AATTGGCCGTG -> ATTGGCCGTGA
ATTGGCCGTGA -> TTGGCCGTGAC
TTGGCCGTGAC -> TGGCCGTGACG
TGGCCGTGACG -> GGCCGTGACGA
GGCCGTGACGA -> GCCGTGACGAA
GCCGTGACGAA -> CCGTGACGAAA
CCGTGACGAAA -> CGTGACGAAAA
CGTGACGAAAA -> GTGACGAAAAT
GTGACGAAAAT -> TGACGAAAATG
TGACGAAAATG -> GACGAAAATGC
GACGAAAATGC -> ACGAAAATGCA
ACGAAAATGCA -> CGAAAATGCAA
CGAAAATGCAA -> GAAAATGCAAG
GAAAATGCAAG -> AAAATGCAAGT
AAAATGCAAGT -> AAATGCAAGTT
AAATGCAAGTT -> AATGCAAGTTA
AATGCAAGTTA -> ATGCAAGTTAA
ATGCAAGTTAA -> TGCAAGTTAAG
TGCAAGTTAAG -> GCAAGTTAAGA
GCAAGTTAAGA -> CAAGTTAAGAA
CAAGTTAAGAA -> AAGTTAAGAAC
AAGTTAAGAAC -> AGTTAAGAACG
AGTTAAGAACG -> GTTAAGAACGG
GTTAAGAACGG -> TTAAGAACGGC
TTAAGAACGGC -> TAAGAACGGCT
TAAGAACGGCT -> AAGAACGGCTC
AAGAACGGCTC -> AGAACGGCTCG
AGAACGGCTCG -> GAACGGCTCGA
GAACGGCTCGA -> AACGGCTCGAG
AACGGCTCGAG -> ACGGCTCGAGG
ACGGCTCGAGG -> CGGCTCGAGGC
CGGCTCGAGGC -> GGCTCGAGGCG
GGCTCGAGGCG -> GCTCGAGGCGG
GCTCGAGGCGG -> CTCGAGGCGGG
CTCGAGGCGGG -> TCGAGGCGGGA
TCGAGGCGGGA -> CGAGGCGGGAG
CGAGGCGGGAG -> GAGGCGGGAGT
GAGGCGGGAGT -> AGGCGGGAGTC
AGGCGGGAGTC -> GGCGGGAGTCA
GGCGGGAGTCA -> GCGGGAGTCAC
GCGGGAGTCAC -> CGGGAGTCACC
CGGGAGTCACC -> GGGAGTCACCA
GGGAGTCACCA -> GGAGTCACCAA
GGAGTCACCAA -> GAGTCACCAAC
GAGTCACCAAC -> AGTCACCAACC
AGTCACCAACC -> GTCACCAACCT
GTCACCAACCT -> TCACCAACCTC
TCACCAACCTC -> CACCAACCTCC
CACCAACCTCC -> ACCAACCTCCA
ACCAACCTCCA -> CCAACCTCCAC
CCAACCTCCAC -> CAACCTCCACG
CAACCTCCACG -> AACCTCCACGA
AACCTCCACGA -> ACCTCCACGAT
ACCTCCACGAT -> CCTCCACGATG
CCTCCACGATG -> CTCCACGATGC
CTCCACGATGC -> TCCACGATGCA
TCCACGATGCA -> CCACGATGCAA
CCACGATGCAA -> CACGATGCAAA
CACGATGCAAA -> ACGATGCAAAG
ACGATGCAAAG -> CGATGCAAAGC
CGATGCAAAGC -> GATGCAAAGCA
GATGCAAAGCA -> ATGCAAAGCAA
ATGCAAAGCAA -> TGCAAAGCAAT
TGCAAAGCAAT -> GCAAAGCAATC
GCAAAGCAATC -> CAAAGCAATCC
CAAAGCAATCC -> AAAGCAATCCG
AAAGCAATCCG -> AAGCAATCCGG
AAGCAATCCGG -> AGCAATCCGGT
AGCAATCCGGT -> GCAATCCGGTA
GCAATCCGGTA -> CAATCCGGTAA
CAATCCGGTAA -> AATCCGGTAAC
AATCCGGTAAC -> ATCCGGTAACT
ATCCGGTAACT -> TCCGGTAACTT
TCCGGTAACTT -> CCGGTAACTTT
CCGGTAACTTT -> CGGTAACTTTT
CGGTAACTTTT -> GGTAACTTTTA
GGTAACTTTTA -> GTAACTTTTAT
GTAACTTTTAT -> TAACTTTTATT
TAACTTTTATT -> AACTTTTATTA
AACTTTTATTA -> ACTTTTATTAA
ACTTTTATTAA -> CTTTTATTAAA
CTTTTATTAAA -> TTTTATTAAAG
TTTTATTAAAG -> TTTATTAAAGC
TTTATTAAAGC -> TTATTAAAGCT
TTATTAAAGCT -> TATTAAAGCTC
TATTAAAGCTC -> ATTAAAGCTCT
ATTAAAGCTCT -> TTAAAGCTCTT
TTAAAGCTCTT -> TAAAGCTCTTG
TAAAGCTCTTG -> AAAGCTCTTGA
AAAGCTCTTGA -> AAGCTCTTGAA
AAGCTCTTGAA -> AGCTCTTGAAT
AGCTCTTGAAT -> GCTCTTGAATC
GCTCTTGAATC -> CTCTTGAATCA
CTCTTGAATCA -> TCTTGAATCAT
TCTTGAATCAT -> CTTGAATCATC
CTTGAATCATC -> TTGAATCATCT
TTGAATCATCT -> TGAATCATCTT
TGAATCATCTT -> GAATCATCTTC
GAATCATCTTC -> AATCATCTTCG
AATCATCTTCG -> ATCATCTTCGA
ATCATCTTCGA -> TCATCTTCGAG
TCATCTTCGAG -> CATCTTCGAGA
CATCTTCGAGA -> ATCTTCGAGAG
ATCTTCGAGAG -> TCTTCGAGAGG
TCTTCGAGAGG -> CTTCGAGAGGC
CTTCGAGAGGC -> TTCGAGAGGCA
TTCGAGAGGCA -> TCGAGAGGCAG
TCGAGAGGCAG -> CGAGAGGCAGA
CGAGAGGCAGA -> GAGAGGCAGAA
GAGAGGCAGAA -> AGAGGCAGAAC
AGAGGCAGAAC -> GAGGCAGAACA
GAGGCAGAACA -> AGGCAGAACAC
AGGCAGAACAC -> GGCAGAACACA
GGCAGAACACA -> GCAGAACACAT
GCAGAACACAT -> CAGAACACATG
CAGAACACATG -> AGAACACATGA
AGAACACATGA -> GAACACATGAG
GAACACATGAG -> AACACATGAGC
AACACATGAGC -> ACACATGAGCC
ACACATGAGCC -> CACATGAGCCG
CACATGAGCCG -> ACATGAGCCGT
ACATGAGCCGT -> CATGAGCCGTG
CATGAGCCGTG -> ATGAGCCGTGC
ATGAGCCGTGC -> TGAGCCGTGCA
TGAGCCGTGCA -> GAGCCGTGCAA
GAGCCGTGCAA -> AGCCGTGCAAG
AGCCGTGCAAG -> GCCGTGCAAGC
GCCGTGCAAGC -> CCGTGCAAGCT
CCGTGCAAGCT -> CGTGCAAGCTC
CGTGCAAGCTC -> GTGCAAGCTCA
GTGCAAGCTCA -> TGCAAGCTCAT
TGCAAGCTCAT -> GCAAGCTCATC
GCAAGCTCATC -> CAAGCTCATCG
CAAGCTCATCG -> AAGCTCATCGT
AAGCTCATCGT -> AGCTCATCGTG
AGCTCATCGTG -> GCTCATCGTGT
GCTCATCGTGT -> CTCATCGTGTT
CTCATCGTGTT -> TCATCGTGTTA
TCATCGTGTTA -> CATCGTGTTAC
CATCGTGTTAC -> ATCGTGTTACT
ATCGTGTTACT -> TCGTGTTACTG
TCGTGTTACTG -> CGTGTTACTGC
CGTGTTACTGC -> GTGTTACTGCA
GTGTTACTGCA -> TGTTACTGCAA
TGTTACTGCAA -> GTTACTGCAAA
GTTACTGCAAA -> TTACTGCAAAA
TTACTGCAAAA -> TACTGCAAAAG
TACTGCAAAAG -> ACTGCAAAAGT
ACTGCAAAAGT -> CTGCAAAAGTT
CTGCAAAAGTT -> TGCAAAAGTTC
TGCAAAAGTTC -> GCAAAAGTTCG
GCAAAAGTTCG -> CAAAAGTTCGT
CAAAAGTTCGT -> AAAAGTTCGTC
AAAAGTTCGTC -> AAAGTTCGTCG
AAAGTTCGTCG -> AAGTTCGTCGA
AAGTTCGTCGA -> AGTTCGTCGAC
AGTTCGTCGAC -> GTTCGTCGACT
GTTCGTCGACT -> TTCGTCGACTA
TTCGTCGACTA -> TCGTCGACTAC
TCGTCGACTAC -> CGTCGACTACT
CGTCGACTACT -> GTCGACTACTA
GTCGACTACTA -> TCGACTACTAT
TCGACTACTAT -> CGACTACTATC
CGACTACTATC -> GACTACTATCT
GACTACTATCT -> ACTACTATCTA
ACTACTATCTA -> CTACTATCTAA
CTACTATCTAA -> TACTATCTAAT
TACTATCTAAT -> ACTATCTAATC
ACTATCTAATC -> CTATCTAATCG
CTATCTAATCG -> TATCTAATCGA
TATCTAATCGA -> ATCTAATCGAG
ATCTAATCGAG -> TCTAATCGAGT
TCTAATCGAGT -> CTAATCGAGTG
CTAATCGAGTG -> TAATCGAGTGG
TAATCGAGTGG -> AATCGAGTGGC
AATCGAGTGGC -> ATCGAGTGGCC
ATCGAGTGGCC -> TCGAGTGGCCT
TCGAGTGGCCT -> CGAGTGGCCTG
CGAGTGGCCTG -> GAGTGGCCTGG
GAGTGGCCTGG -> AGTGGCCTGGC
AGTGGCCTGGC -> GTGGCCTGGCT
GTGGCCTGGCT -> TGGCCTGGCTT
TGGCCTGGCTT -> GGCCTGGCTTA
GGCCTGGCTTA -> GCCTGGCTTAA
GCCTGGCTTAA -> CCTGGCTTAAA
CCTGGCTTAAA -> CTGGCTTAAAT
CTGGCTTAAAT -> TGGCTTAAATC
TGGCTTAAATC -> GGCTTAAATCT
GGCTTAAATCT -> GCTTAAATCTA
GCTTAAATCTA -> CTTAAATCTAC
CTTAAATCTAC -> TTAAATCTACG
TTAAATCTACG -> TAAATCTACGC
TAAATCTACGC -> AAATCTACGCT
AAATCTACGCT -> AATCTACGCTA
AATCTACGCTA -> ATCTACGCTAA
ATCTACGCTAA -> TCTACGCTAAT
TCTACGCTAAT -> CTACGCTAATC
CTACGCTAATC -> TACGCTAATCT
TACGCTAATCT -> ACGCTAATCTT
ACGCTAATCTT -> CGCTAATCTTG
CGCTAATCTTG -> GCTAATCTTGG
GCTAATCTTGG -> CTAATCTTGGC
CTAATCTTGGC -> TAATCTTGGCT
TAATCTTGGCT -> AATCTTGGCTA
AATCTTGGCTA -> ATCTTGGCTAT
ATCTTGGCTAT -> TCTTGGCTATT
TCTTGGCTATT -> CTTGGCTATTG
CTTGGCTATTG -> TTGGCTATTGA
TTGGCTATTGA -> TGGCTATTGAT
TGGCTATTGAT -> GGCTATTGATA
GGCTATTGATA -> GCTATTGATAG
GCTATTGATAG -> CTATTGATAGC
CTATTGATAGC -> TATTGATAGCC
TATTGATAGCC -> ATTGATAGCCT
ATTGATAGCCT -> TTGATAGCCTA
TTGATAGCCTA -> TGATAGCCTAT
TGATAGCCTAT -> GATAGCCTATA
GATAGCCTATA -> ATAGCCTATAT
ATAGCCTATAT -> TAGCCTATATT
TAGCCTATATT -> AGCCTATATTC
AGCCTATATTC -> GCCTATATTCA
GCCTATATTCA -> CCTATATTCAG
CCTATATTCAG -> CTATATTCAGT
CTATATTCAGT -> TATATTCAGTC
TATATTCAGTC -> ATATTCAGTCA
ATATTCAGTCA -> TATTCAGTCAA
TATTCAGTCAA -> ATTCAGTCAAT
ATTCAGTCAAT -> TTCAGTCAATT
TTCAGTCAATT -> TCAGTCAATTT
TCAGTCAATTT -> CAGTCAATTTC
CAGTCAATTTC -> AGTCAATTTCG
AGTCAATTTCG -> GTCAATTTCGC
GTCAATTTCGC -> TCAATTTCGCA
TCAATTTCGCA -> CAATTTCGCAC
CAATTTCGCAC -> AATTTCGCACG
AATTTCGCACG -> ATTTCGCACGG
ATTTCGCACGG -> TTTCGCACGGT
TTTCGCACGGT -> TTCGCACGGTT
TTCGCACGGTT -> TCGCACGGTTG
TCGCACGGTTG -> CGCACGGTTGA
CGCACGGTTGA -> GCACGGTTGAA
GCACGGTTGAA -> CACGGTTGAAC
CACGGTTGAAC -> ACGGTTGAACC
ACGGTTGAACC -> CGGTTGAACCG
CGGTTGAACCG -> GGTTGAACCGG
GGTTGAACCGG -> GTTGAACCGGG
GTTGAACCGGG -> TTGAACCGGGC
TTGAACCGGGC -> TGAACCGGGCG
TGAACCGGGCG -> GAACCGGGCGG
GAACCGGGCGG -> AACCGGGCGGG
AACCGGGCGGG -> ACCGGGCGGGA
ACCGGGCGGGA -> CCGGGCGGGAG
CCGGGCGGGAG -> CGGGCGGGAGG
CGGGCGGGAGG -> GGGCGGGAGGA
GGGCGGGAGGA -> GGCGGGAGGAA
GGCGGGAGGAA -> GCGGGAGGAAC
GCGGGAGGAAC -> CGGGAGGAACG
CGGGAGGAACG -> GGGAGGAACGG
GGGAGGAACGG -> GGAGGAACGGT
GGAGGAACGGT -> GAGGAACGGTT
GAGGAACGGTT -> AGGAACGGTTG
AGGAACGGTTG -> GGAACGGTTGA
GGAACGGTTGA -> GAACGGTTGAT
GAACGGTTGAT -> AACGGTTGATT
AACGGTTGATT -> ACGGTTGATTC
ACGGTTGATTC -> CGGTTGATTCA
CGGTTGATTCA -> GGTTGATTCAA
GGTTGATTCAA -> GTTGATTCAAC
GTTGATTCAAC -> TTGATTCAACA
TTGATTCAACA -> TGATTCAACAA
TGATTCAACAA -> GATTCAACAAT
GATTCAACAAT -> ATTCAACAATC
ATTCAACAATC -> TTCAACAATCT
TTCAACAATCT -> TCAACAATCTT
TCAACAATCTT -> CAACAATCTTC
CAACAATCTTC -> AACAATCTTCT
AACAATCTTCT -> ACAATCTTCTC
ACAATCTTCTC -> CAATCTTCTCT
CAATCTTCTCT -> AATCTTCTCTT
AATCTTCTCTT -> ATCTTCTCTTC
ATCTTCTCTTC -> TCTTCTCTTCG
TCTTCTCTTCG -> CTTCTCTTCGT
CTTCTCTTCGT -> TTCTCTTCGTT
TTCTCTTCGTT -> TCTCTTCGTTT
TCTCTTCGTTT -> CTCTTCGTTTG
CTCTTCGTTTG -> TCTTCGTTTGG
TCTTCGTTTGG -> CTTCGTTTGGC
CTTCGTTTGGC -> TTCGTTTGGCT
TTCGTTTGGCT -> TCGTTTGGCTC
TCGTTTGGCTC -> CGTTTGGCTCA
CGTTTGGCTCA -> GTTTGGCTCAT
GTTTGGCTCAT -> TTTGGCTCATG
TTTGGCTCATG -> TTGGCTCATGG
TTGGCTCATGG -> TGGCTCATGGT
TGGCTCATGGT -> GGCTCATGGTT
GGCTCATGGTT -> GCTCATGGTTT
GCTCATGGTTT -> CTCATGGTTTC
CTCATGGTTTC -> TCATGGTTTCC
TCATGGTTTCC -> CATGGTTTCCA
CATGGTTTCCA -> ATGGTTTCCAC
ATGGTTTCCAC -> TGGTTTCCACA
TGGTTTCCACA -> GGTTTCCACAG
GGTTTCCACAG -> GTTTCCACAGA
GTTTCCACAGA -> TTTCCACAGAT
TTTCCACAGAT -> TTCCACAGATA
TTCCACAGATA -> TCCACAGATAG
TCCACAGATAG -> CCACAGATAGT
CCACAGATAGT -> CACAGATAGTA
CACAGATAGTA -> ACAGATAGTAG
ACAGATAGTAG -> CAGATAGTAGA
CAGATAGTAGA -> AGATAGTAGAT
AGATAGTAGAT -> GATAGTAGATC
GATAGTAGATC -> ATAGTAGATCG
ATAGTAGATCG -> TAGTAGATCGG
TAGTAGATCGG -> AGTAGATCGGC
AGTAGATCGGC -> GTAGATCGGCT
GTAGATCGGCT -> TAGATCGGCTT
TAGATCGGCTT -> AGATCGGCTTG
AGATCGGCTTG -> GATCGGCTTGT
GATCGGCTTGT -> ATCGGCTTGTG
ATCGGCTTGTG -> TCGGCTTGTGG
TCGGCTTGTGG -> CGGCTTGTGGA
CGGCTTGTGGA -> GGCTTGTGGAT
GGCTTGTGGAT -> GCTTGTGGATC
GCTTGTGGATC -> CTTGTGGATCC
CTTGTGGATCC -> TTGTGGATCCT
TTGTGGATCCT -> TGTGGATCCTG
TGTGGATCCTG -> GTGGATCCTGG
GTGGATCCTGG -> TGGATCCTGGT
TGGATCCTGGT -> GGATCCTGGTT
GGATCCTGGTT -> GATCCTGGTTT
GATCCTGGTTT -> ATCCTGGTTTA
ATCCTGGTTTA -> TCCTGGTTTAA
TCCTGGTTTAA -> CCTGGTTTAAA
CCTGGTTTAAA -> CTGGTTTAAAT
CTGGTTTAAAT -> TGGTTTAAATC
TGGTTTAAATC -> GGTTTAAATCT
GGTTTAAATCT -> GTTTAAATCTG
GTTTAAATCTG -> TTTAAATCTGT
TTTAAATCTGT -> TTAAATCTGTA
TTAAATCTGTA -> TAAATCTGTAA
TAAATCTGTAA -> AAATCTGTAAA
AAATCTGTAAA -> AATCTGTAAAT
AATCTGTAAAT -> ATCTGTAAATT
ATCTGTAAATT -> TCTGTAAATTT
TCTGTAAATTT -> CTGTAAATTTC
CTGTAAATTTC -> TGTAAATTTCT
TGTAAATTTCT -> GTAAATTTCTC
GTAAATTTCTC -> TAAATTTCTCT
TAAATTTCTCT -> AAATTTCTCTT
AAATTTCTCTT -> AATTTCTCTTC
AATTTCTCTTC -> ATTTCTCTTCA
ATTTCTCTTCA -> TTTCTCTTCAC
TTTCTCTTCAC -> TTCTCTTCACG
TTCTCTTCACG -> TCTCTTCACGG
TCTCTTCACGG -> CTCTTCACGGG
CTCTTCACGGG -> TCTTCACGGGG
TCTTCACGGGG -> CTTCACGGGGG
CTTCACGGGGG -> TTCACGGGGGG
TTCACGGGGGG -> TCACGGGGGGG
TCACGGGGGGG -> CACGGGGGGGA
CACGGGGGGGA -> ACGGGGGGGAG
ACGGGGGGGAG -> CGGGGGGGAGT
CGGGGGGGAGT -> GGGGGGGAGTC
GGGGGGGAGTC -> GGGGGGAGTCT
GGGGGGAGTCT -> GGGGGAGTCTC
GGGGGAGTCTC -> GGGGAGTCTCA
GGGGAGTCTCA -> GGGAGTCTCAT
GGGAGTCTCAT -> GGAGTCTCATG
GGAGTCTCATG -> GAGTCTCATGG
GAGTCTCATGG -> AGTCTCATGGT
AGTCTCATGGT -> GTCTCATGGTC
GTCTCATGGTC -> TCTCATGGTCG
TCTCATGGTCG -> CTCATGGTCGA
CTCATGGTCGA -> TCATGGTCGAT
TCATGGTCGAT -> CATGGTCGATC
CATGGTCGATC -> ATGGTCGATCG
ATGGTCGATCG -> TGGTCGATCGG
TGGTCGATCGG -> GGTCGATCGGT
GGTCGATCGGT -> GTCGATCGGTC
GTCGATCGGTC -> TCGATCGGTCC
TCGATCGGTCC -> CGATCGGTCCA
CGATCGGTCCA -> GATCGGTCCAT
GATCGGTCCAT -> ATCGGTCCATC
ATCGGTCCATC -> TCGGTCCATCG
TCGGTCCATCG -> CGGTCCATCGG
CGGTCCATCGG -> GGTCCATCGGA
GGTCCATCGGA -> GTCCATCGGAT
GTCCATCGGAT -> TCCATCGGATG
TCCATCGGATG -> CCATCGGATGG
CCATCGGATGG -> CATCGGATGGC
CATCGGATGGC -> ATCGGATGGCA
ATCGGATGGCA -> TCGGATGGCAG
TCGGATGGCAG -> CGGATGGCAGA
CGGATGGCAGA -> GGATGGCAGAG
GGATGGCAGAG -> GATGGCAGAGG
GATGGCAGAGG -> ATGGCAGAGGG
ATGGCAGAGGG -> TGGCAGAGGGG
TGGCAGAGGGG -> GGCAGAGGGGA
GGCAGAGGGGA -> GCAGAGGGGAC
GCAGAGGGGAC -> CAGAGGGGACA
CAGAGGGGACA -> AGAGGGGACAG
AGAGGGGACAG -> GAGGGGACAGC
GAGGGGACAGC -> AGGGGACAGCT
AGGGGACAGCT -> GGGGACAGCTG
GGGGACAGCTG -> GGGACAGCTGT
GGGACAGCTGT -> GGACAGCTGTA
GGACAGCTGTA -> GACAGCTGTAT
GACAGCTGTAT -> ACAGCTGTATA
ACAGCTGTATA -> CAGCTGTATAA
CAGCTGTATAA -> AGCTGTATAAC
AGCTGTATAAC -> GCTGTATAACG
GCTGTATAACG -> CTGTATAACGT
CTGTATAACGT -> TGTATAACGTG
TGTATAACGTG -> GTATAACGTGG
GTATAACGTGG -> TATAACGTGGC
TATAACGTGGC -> ATAACGTGGCA
ATAACGTGGCA -> TAACGTGGCAT
TAACGTGGCAT -> AACGTGGCATA
AACGTGGCATA -> ACGTGGCATAA
ACGTGGCATAA -> CGTGGCATAAA
CGTGGCATAAA -> GTGGCATAAAC
GTGGCATAAAC -> TGGCATAAACC
TGGCATAAACC -> GGCATAAACCC
GGCATAAACCC -> GCATAAACCCA
GCATAAACCCA -> CATAAACCCAA
CATAAACCCAA -> ATAAACCCAAT
ATAAACCCAAT -> TAAACCCAATT
TAAACCCAATT -> AAACCCAATTG
AAACCCAATTG -> AACCCAATTGC
AACCCAATTGC -> ACCCAATTGCG
ACCCAATTGCG -> CCCAATTGCGA
CCCAATTGCGA -> CCAATTGCGAC
CCAATTGCGAC -> CAATTGCGACA
CAATTGCGACA -> AATTGCGACAA
AATTGCGACAA -> ATTGCGACAAG
ATTGCGACAAG -> TTGCGACAAGC
TTGCGACAAGC -> TGCGACAAGCG
TGCGACAAGCG -> GCGACAAGCGA
GCGACAAGCGA -> CGACAAGCGAG
CGACAAGCGAG -> GACAAGCGAGT
GACAAGCGAGT -> ACAAGCGAGTG
ACAAGCGAGTG -> CAAGCGAGTGA
CAAGCGAGTGA -> AAGCGAGTGAC
AAGCGAGTGAC -> AGCGAGTGACA
AGCGAGTGACA -> GCGAGTGACAA
GCGAGTGACAA -> CGAGTGACAAA
CGAGTGACAAA -> GAGTGACAAAG
GAGTGACAAAG -> AGTGACAAAGA
AGTGACAAAGA -> GTGACAAAGAA
GTGACAAAGAA -> TGACAAAGAAT
TGACAAAGAAT -> GACAAAGAATG
GACAAAGAATG -> ACAAAGAATGT
ACAAAGAATGT -> CAAAGAATGTG
CAAAGAATGTG -> AAAGAATGTGA
AAAGAATGTGA -> AAGAATGTGAT
AAGAATGTGAT -> AGAATGTGATT
AGAATGTGATT -> GAATGTGATTG
GAATGTGATTG -> AATGTGATTGG
AATGTGATTGG -> ATGTGATTGGC
ATGTGATTGGC -> TGTGATTGGCC
TGTGATTGGCC -> GTGATTGGCCC
GTGATTGGCCC -> TGATTGGCCCA
TGATTGGCCCA -> GATTGGCCCAA
GATTGGCCCAA -> ATTGGCCCAAG
ATTGGCCCAAG -> TTGGCCCAAGG
TTGGCCCAAGG -> TGGCCCAAGGT
TGGCCCAAGGT -> GGCCCAAGGTG
GGCCCAAGGTG -> GCCCAAGGTGC
GCCCAAGGTGC -> CCCAAGGTGCG
CCCAAGGTGCG -> CCAAGGTGCGC
CCAAGGTGCGC -> CAAGGTGCGCT
CAAGGTGCGCT -> AAGGTGCGCTT
AAGGTGCGCTT -> AGGTGCGCTTT
AGGTGCGCTTT -> GGTGCGCTTTG
GGTGCGCTTTG -> GTGCGCTTTGG
GTGCGCTTTGG -> TGCGCTTTGGT
TGCGCTTTGGT -> GCGCTTTGGTT
GCGCTTTGGTT -> CGCTTTGGTTG
CGCTTTGGTTG -> GCTTTGGTTGG
GCTTTGGTTGG -> CTTTGGTTGGG
CTTTGGTTGGG -> TTTGGTTGGGT
TTTGGTTGGGT -> TTGGTTGGGTG
TTGGTTGGGTG -> TGGTTGGGTGC
TGGTTGGGTGC -> GGTTGGGTGCT
GGTTGGGTGCT -> GTTGGGTGCTG
GTTGGGTGCTG -> TTGGGTGCTGC
TTGGGTGCTGC -> TGGGTGCTGCG
TGGGTGCTGCG -> GGGTGCTGCGA
GGGTGCTGCGA -> GGTGCTGCGAA
GGTGCTGCGAA -> GTGCTGCGAAA
GTGCTGCGAAA -> TGCTGCGAAAT
TGCTGCGAAAT -> GCTGCGAAATG
GCTGCGAAATG -> CTGCGAAATGA
CTGCGAAATGA -> TGCGAAATGAT
TGCGAAATGAT -> GCGAAATGATA
GCGAAATGATA -> CGAAATGATAT
CGAAATGATAT -> GAAATGATATA
GAAATGATATA -> AAATGATATAG
AAATGATATAG -> AATGATATAGT
AATGATATAGT -> ATGATATAGTA
ATGATATAGTA -> TGATATAGTAT
TGATATAGTAT -> GATATAGTATA
GATATAGTATA -> ATATAGTATAA
ATATAGTATAA -> TATAGTATAAA
TATAGTATAAA -> ATAGTATAAAC
ATAGTATAAAC -> TAGTATAAACG
TAGTATAAACG -> AGTATAAACGT
AGTATAAACGT -> GTATAAACGTG
GTATAAACGTG -> TATAAACGTGA
TATAAACGTGA -> ATAAACGTGAG
ATAAACGTGAG -> TAAACGTGAGA
TAAACGTGAGA -> AAACGTGAGAA
AAACGTGAGAA -> AACGTGAGAAC
AACGTGAGAAC -> ACGTGAGAACG
ACGTGAGAACG -> CGTGAGAACGT
CGTGAGAACGT -> GTGAGAACGTG
GTGAGAACGTG -> TGAGAACGTGA
TGAGAACGTGA -> GAGAACGTGAG
GAGAACGTGAG -> AGAACGTGAGG
AGAACGTGAGG -> GAACGTGAGGA
GAACGTGAGGA -> AACGTGAGGAG
AACGTGAGGAG -> ACGTGAGGAGA
ACGTGAGGAGA -> CGTGAGGAGAG
CGTGAGGAGAG -> GTGAGGAGAGT
GTGAGGAGAGT -> TGAGGAGAGTA
TGAGGAGAGTA -> GAGGAGAGTAA
GAGGAGAGTAA -> AGGAGAGTAAT
AGGAGAGTAAT -> GGAGAGTAATG
GGAGAGTAATG -> GAGAGTAATGT
GAGAGTAATGT -> AGAGTAATGTC
AGAGTAATGTC -> GAGTAATGTCG
GAGTAATGTCG -> AGTAATGTCGA
AGTAATGTCGA -> GTAATGTCGAT
GTAATGTCGAT -> TAATGTCGATC
TAATGTCGATC -> AATGTCGATCG
AATGTCGATCG -> ATGTCGATCGT
ATGTCGATCGT -> TGTCGATCGTG
TGTCGATCGTG -> GTCGATCGTGT
GTCGATCGTGT -> TCGATCGTGTT
TCGATCGTGTT -> CGATCGTGTTC
CGATCGTGTTC -> GATCGTGTTCA
GATCGTGTTCA -> ATCGTGTTCAG
ATCGTGTTCAG -> TCGTGTTCAGA
TCGTGTTCAGA -> CGTGTTCAGAG
CGTGTTCAGAG -> GTGTTCAGAGG
GTGTTCAGAGG -> TGTTCAGAGGT
TGTTCAGAGGT -> GTTCAGAGGTT
GTTCAGAGGTT -> TTCAGAGGTTG
TTCAGAGGTTG -> TCAGAGGTTGA
TCAGAGGTTGA -> CAGAGGTTGAG
CAGAGGTTGAG -> AGAGGTTGAGT
AGAGGTTGAGT -> GAGGTTGAGTA
GAGGTTGAGTA -> AGGTTGAGTAA
AGGTTGAGTAA -> GGTTGAGTAAG
GGTTGAGTAAG -> GTTGAGTAAGT
GTTGAGTAAGT -> TTGAGTAAGTG
TTGAGTAAGTG -> TGAGTAAGTGA
TGAGTAAGTGA -> GAGTAAGTGAA
GAGTAAGTGAA -> AGTAAGTGAAT
AGTAAGTGAAT -> GTAAGTGAATG
GTAAGTGAATG -> TAAGTGAATGA
TAAGTGAATGA -> AAGTGAATGAC
AAGTGAATGAC -> AGTGAATGACA
AGTGAATGACA -> GTGAATGACAT
GTGAATGACAT -> TGAATGACATT
TGAATGACATT -> GAATGACATTT
GAATGACATTT -> AATGACATTTC
AATGACATTTC -> ATGACATTTCT
ATGACATTTCT -> TGACATTTCTC
TGACATTTCTC -> GACATTTCTCT
GACATTTCTCT -> ACATTTCTCTC
ACATTTCTCTC -> CATTTCTCTCA
CATTTCTCTCA -> ATTTCTCTCAT
ATTTCTCTCAT -> TTTCTCTCATA
TTTCTCTCATA -> TTCTCTCATAC
TTCTCTCATAC -> TCTCTCATACA
TCTCTCATACA -> CTCTCATACAT