TTCATGTTTCG -> TCATGTTTCGG
AATCTAAGCAA -> ATCTAAGCAAG
TGACTGATACG -> GACTGATACGT
GACCGGCACTA -> ACCGGCACTAT
AGTACTTGGCC -> GTACTTGGCCT
GTGGTGCGCAA -> TGGTGCGCAAG
GTATCTCTAGA -> TATCTCTAGAT
GTTCTAGCGGA -> TTCTAGCGGAG
GATTGTCGCTC -> ATTGTCGCTCT
CAAGAGACCAG -> AAGAGACCAGT
CTGTTTGATGA -> TGTTTGATGAC
ACAATCAGATC -> CAATCAGATCC
AAAGCGAGCGA -> AAGCGAGCGAG
TCGCGGTTGAC -> CGCGGTTGACT
TGCCCTGAGTT -> GCCCTGAGTTA
GCTCCCACGAA -> CTCCCACGAAC
TGGCGCCGTTC -> GGCGCCGTTCT
TCCTGCTCACC -> CCTGCTCACCC
ACCTCGTCTTT -> CCTCGTCTTTT
AACGGTCGTCG -> ACGGTCGTCGT
TTACCTAGCGT -> TACCTAGCGTA
CCAAGCATACG -> CAAGCATACGG
GGCGTGGGAGA -> GCGTGGGAGAG
TGAGGTGTATA -> GAGGTGTATAC
CTTTCTCCTGC -> TTTCTCCTGCT
CGCGTTTACAA -> GCGTTTACAAC
TCCGCTTTAGC -> CCGCTTTAGCG
AGCTACGCCGC -> GCTACGCCGCT
CATTCACTGAC -> ATTCACTGACG
GAGCAGTGGTG -> AGCAGTGGTGC
CGCCTCTCACC -> GCCTCTCACCG
TACGCCGAGCG -> ACGCCGAGCGC
GGCGACTAGGA -> GCGACTAGGAT
GATGTTTCACT -> ATGTTTCACTC
TAGGTTGTTAT -> AGGTTGTTATA
TCGGTCCCCGG -> CGGTCCCCGGC
GTCGAGAACAC -> TCGAGAACACT
CGCTTGTGATG -> GCTTGTGATGG
TTGTACTCAGG -> TGTACTCAGGG
GGTGCGCAAGG -> GTGCGCAAGGG
GTTCTCTCGCT -> TTCTCTCGCTT
TGAACGTAACC -> GAACGTAACCT
AGAAAGCGAGC -> GAAAGCGAGCG
CAATCCGGATA -> AATCCGGATAG
CTGTAATCACG -> TGTAATCACGC
GATGATGGAGT -> ATGATGGAGTC
GGTCGAGAACA -> GTCGAGAACAC
TGAGTGCTTCT -> GAGTGCTTCTT
ATGCGGTGTGA -> TGCGGTGTGAT
GAAAGCGAGCG -> AAAGCGAGCGA
TAGCTGCCCTG -> AGCTGCCCTGA
CGGGCGTGGGA -> GGGCGTGGGAG
TTTGTATCATC -> TTGTATCATCT
CTAGCGTCAGT -> TAGCGTCAGTA
CTTGGTGCCGG -> TTGGTGCCGGA
ATGAGTAAATG -> TGAGTAAATGA
GCACCGTCATG -> CACCGTCATGA
TGCGGTGTGAT -> GCGGTGTGATT
ATGGTCCAGAA -> TGGTCCAGAAG
GGGTCTAGTTG -> GGTCTAGTTGT
GTAATCACGCC -> TAATCACGCCC
TTACAACCATA -> TACAACCATAG
CGGGTCAGGCG -> GGGTCAGGCGC
CTTGCGGGGTA -> TTGCGGGGTAG
TCATATTAACG -> CATATTAACGG
CCGTGCGCGAG -> CGTGCGCGAGA
GAGCGGGCCTT -> AGCGGGCCTTG
GTTACTATTGG -> TTACTATTGGT
CTCTATTCTCT -> TCTATTCTCTT
GTGCCCAGGTT -> TGCCCAGGTTA
ACACATTAGGG -> CACATTAGGGC
CGCGTCGATTG -> GCGTCGATTGC
GCGAGGTTGGC -> CGAGGTTGGCG
GATACAACGTC -> ATACAACGTCC
AAATTGTCTTG -> AATTGTCTTGT
CTGACCGAGAG -> TGACCGAGAGA
TTCTTGAGCGG -> TCTTGAGCGGG
AGGTTGTTATA -> GGTTGTTATAA
GTACCGTGCGC -> TACCGTGCGCG
CACGAACCGAA -> ACGAACCGAAG
GAGGCAGCCGT -> AGGCAGCCGTC
CCGTTACTGAA -> CGTTACTGAAG
GTATACGGCGA -> TATACGGCGAA
AAAGTCTCTGT -> AAGTCTCTGTC
CCCAGAAACAT -> CCAGAAACATG
ACTGTTCTCTC -> CTGTTCTCTCG
ATACCTGGGTC -> TACCTGGGTCT
CGGAAGTTACC -> GGAAGTTACCT
GCGGTTGACTA -> CGGTTGACTAG
TGCCACAGCAT -> GCCACAGCATA
CACAGCATACA -> ACAGCATACAT
CGTTGCCATTA -> GTTGCCATTAG
CGGTAGTCATC -> GGTAGTCATCC
TAGCGTGGTAT -> AGCGTGGTATC
TATTGTTAAAT -> ATTGTTAAATA
CTTTAGCGTGG -> TTTAGCGTGGT
TGTGCCCAGGT -> GTGCCCAGGTT
GTGGTAATGAG -> TGGTAATGAGT
TCGGCAGGGCG -> CGGCAGGGCGG
TAATCACGCCC -> AATCACGCCCT
GAACCGAAGAT -> AACCGAAGATC
ACCGCTCTAAA -> CCGCTCTAAAA
GGGACGTCATA -> GGACGTCATAT
TCTGTCCAGAA -> CTGTCCAGAAA
CGCGTAGTCCA -> GCGTAGTCCAA
CGATCGCACAC -> GATCGCACACA
GGACTGAGTGC -> GACTGAGTGCT
AATCACGCCCT -> ATCACGCCCTA
CACTCCACGGT -> ACTCCACGGTA
CAGATCCAACA -> AGATCCAACAC
CCACGGTAGTC -> CACGGTAGTCA
GGGACAAGAAT -> GGACAAGAATC
GGAGTTACTAT -> GAGTTACTATT
AGTGGTGCGCA -> GTGGTGCGCAA
TAGCACAATCA -> AGCACAATCAG
AGGGATGTTTC -> GGGATGTTTCA
GTGCGCGAGAG -> TGCGCGAGAGT
TCGCTTGTGAT -> CGCTTGTGATG
TATTAGAGCCT -> ATTAGAGCCTG
GGTATCTCTAG -> GTATCTCTAGA
TGATCCAAGCA -> GATCCAAGCAT
GAGATACAACG -> AGATACAACGT
ACAGGCCAGGC -> CAGGCCAGGCG
GAAGCCGGTAC -> AAGCCGGTACA
TCTCTCTCGGC -> CTCTCTCGGCA
TGTTATAAGAC -> GTTATAAGACC
TTAGAGAGCGG -> TAGAGAGCGGG
CCGGCACTATG -> CGGCACTATGC
TCTCACCGATT -> CTCACCGATTT
GCTGATCCAAG -> CTGATCCAAGC
ATGAGGGTACA -> TGAGGGTACAC
ACGCTCGGTTT -> CGCTCGGTTTG
CGAGGTTGGCG -> GAGGTTGGCGC
GGTCCAGAAGT -> GTCCAGAAGTA
CTCCACGGTAG -> TCCACGGTAGT
GTGCTTCTTGA -> TGCTTCTTGAG
GGCTGATCCAA -> GCTGATCCAAG
GACGGCAATCC -> ACGGCAATCCT
CTTTATCAAGA -> TTTATCAAGAG
TCATGTTTCGG -> CATGTTTCGGT
GTAGCTACGCC -> TAGCTACGCCG
AGAAACGGTCG -> GAAACGGTCGT
ACTCACCTCGT -> CTCACCTCGTC
TACTTGGCCTT -> ACTTGGCCTTG
GTCATATTAAC -> TCATATTAACG
TGTACACGATA -> GTACACGATAT
TGACCGGCACT -> GACCGGCACTA
CGTAACCTTGT -> GTAACCTTGTG
GTCATGATGGT -> TCATGATGGTG
TAGACTGGGAA -> AGACTGGGAAA
CAAGCATACGG -> AAGCATACGGC
TCAGCTAATTA -> CAGCTAATTAC
CTCCTGCTCAC -> TCCTGCTCACC
CCTCACCTCTC -> CTCACCTCTCC
TTGGAGGCATA -> TGGAGGCATAA
GCTGTGCCCAG -> CTGTGCCCAGG
TTGTACACGAT -> TGTACACGATA
GCGTGGTATCT -> CGTGGTATCTC
GCGAGCGAGGT -> CGAGCGAGGTT
ACTGATACGTA -> CTGATACGTAG
AATAGCGTCTG -> ATAGCGTCTGC
AGGCGACAGCA -> GGCGACAGCAC
CATTAGCACAA -> ATTAGCACAAT
GGTAGTAGACC -> GTAGTAGACCT
CGTGGGAGAGG -> GTGGGAGAGGA
CAGGTTATGGT -> AGGTTATGGTG
AGTTCTTGGAG -> GTTCTTGGAGG
AGCGTAAAAGG -> GCGTAAAAGGG
GATTTGCCCTA -> ATTTGCCCTAG
CGATATCCGCG -> GATATCCGCGT
ATCCACCTCAA -> TCCACCTCAAA
TGATTACGATC -> GATTACGATCG
ACAGTTTTTCG -> CAGTTTTTCGC
GGCCCACGCAT -> GCCCACGCATT
ATCCGGATAGC -> TCCGGATAGCA
ATGTGGTTCGG -> TGTGGTTCGGT
CTAAAATTGAG -> TAAAATTGAGA
ATAACAGTGCC -> TAACAGTGCCT
CCATAAAATCC -> CATAAAATCCT
TGCCGGAGTTC -> GCCGGAGTTCT
CATGATGGTGA -> ATGATGGTGAC
GGACGTCATAT -> GACGTCATATA
AGGCGACTAGG -> GGCGACTAGGA
TCGATGACCGG -> CGATGACCGGC
CAGCCGTCATG -> AGCCGTCATGA
CTCGATCACTT -> TCGATCACTTG
ACTTGGCCTTG -> CTTGGCCTTGC
AAGCCTGCTTT -> AGCCTGCTTTG
TTTGGTTGCCA -> TTGGTTGCCAT
AATTGAGAGCG -> ATTGAGAGCGC
CTGTGCCCAGG -> TGTGCCCAGGT
AGGTGTATACG -> GGTGTATACGC
CCACCTCAAAC -> CACCTCAAACG
AGATTCGCGTC -> GATTCGCGTCG
CGCTGTACAAG -> GCTGTACAAGC
CGTTTACAACC -> GTTTACAACCA
TACAAGCGTCT -> ACAAGCGTCTC
ACGCGCCACTC -> CGCGCCACTCT
AAATCCGCTTT -> AATCCGCTTTA
CGATTTGCCCT -> GATTTGCCCTA
AAGAATCCAGT -> AGAATCCAGTT
TGTATACGGCG -> GTATACGGCGA
GACGTACGGGC -> ACGTACGGGCG
CAGAAACATGG -> AGAAACATGGT
ATATGCGGTGT -> TATGCGGTGTG
TCTTCGTAGAC -> CTTCGTAGACG
CCTTTTATTCA -> CTTTTATTCAT
CTTGCACTGAC -> TTGCACTGACC
TTACCATTTCT -> TACCATTTCTT
TCCCCGGCACG -> CCCCGGCACGG
CTACAATCCAA -> TACAATCCAAG
CCTGACGTACG -> CTGACGTACGG
CCAACACAAAT -> CAACACAAATG
TTTCGCGGTTG -> TTCGCGGTTGA
ACCCATGTGGT -> CCCATGTGGTT
CATATCCGCGC -> ATATCCGCGCC
CACTGACGCGC -> ACTGACGCGCC
GTACCGCTCTA -> TACCGCTCTAA
TAGCTGGTATG -> AGCTGGTATGC
AAGCTATTAGC -> AGCTATTAGCT
TCGCCTCTCAC -> CGCCTCTCACC
CCAGAGGATGC -> CAGAGGATGCC
TACAGGCGACA -> ACAGGCGACAG
GATCACTTGCA -> ATCACTTGCAC
AGCGTCAGTAC -> GCGTCAGTACT
TAGACGGCAAT -> AGACGGCAATC
TCCTAAAAGAA -> CCTAAAAGAAA
GGGTAGCATAT -> GGTAGCATATG
GTGCGATCCAC -> TGCGATCCACC
AGCTGGTATGC -> GCTGGTATGCT
CCGCTGTACAA -> CGCTGTACAAG
GCTGGTATGCT -> CTGGTATGCTG
ATAAGGAGCCG -> TAAGGAGCCGC
GCAAATTGTCT -> CAAATTGTCTT
GCAGCCGTCAT -> CAGCCGTCATG
CTCTAAAATTG -> TCTAAAATTGA
GTTACCTAGCG -> TTACCTAGCGT
TGTTGTCCGAT -> GTTGTCCGATG
GGTGCGATCCA -> GTGCGATCCAC
GACCGAGAGAA -> ACCGAGAGAAA
GCTATTAGCTG -> CTATTAGCTGG
TCCCGTACCGT -> CCCGTACCGTA
GTTCTAACTGT -> TTCTAACTGTT
CTTGAGCGGGC -> TTGAGCGGGCC
AATCAATAGCG -> ATCAATAGCGT
CTATTAGCTGG -> TATTAGCTGGT
GTATCATCTAG -> TATCATCTAGT
TACTGAAGCTG -> ACTGAAGCTGA
GCCTTTCTGCT -> CCTTTCTGCTT
TCGTCTTTTAG -> CGTCTTTTAGT
AGTTCACTCGG -> GTTCACTCGGA
CTGCCCTGACG -> TGCCCTGACGT
ATGAGACCTCA -> TGAGACCTCAC
TAGCATATCCG -> AGCATATCCGC
GCCTCGGTAGT -> CCTCGGTAGTA
GAGGTGTATAC -> AGGTGTATACG
GCATTCACTGA -> CATTCACTGAC
TGCAAAATTCG -> GCAAAATTCGA
GCCGTCATGAG -> CCGTCATGAGG
GCGTACCGTGC -> CGTACCGTGCG
GACAGCCACGG -> ACAGCCACGGG
GGCCTTGCGGG -> GCCTTGCGGGG
TAGGCTGATCC -> AGGCTGATCCA
AATATTAGAGA -> ATATTAGAGAG
CACTATGCTCG -> ACTATGCTCGC
AGGCTGATCCA -> GGCTGATCCAA
CTCTTCTGTTT -> TCTTCTGTTTG
CGGCATGTTCG -> GGCATGTTCGT
AACAGTGCCTT -> ACAGTGCCTTT
CGGTTGACTAG -> GGTTGACTAGG
TTCACTCTAAA -> TCACTCTAAAG
GCCTTGCGGGG -> CCTTGCGGGGT
AGCCCAGTTCT -> GCCCAGTTCTA
AGCTGCCCTGA -> GCTGCCCTGAG
CAGGCGACTAG -> AGGCGACTAGG
GAATGCCACAG -> AATGCCACAGC
GCGGTGTGATT -> CGGTGTGATTG
GGGAGAGGAAC -> GGAGAGGAACT
TCCAGAAGTAG -> CCAGAAGTAGT
GAGTTCTTGGA -> AGTTCTTGGAG
AATCAGATCCA -> ATCAGATCCAA
TGGGAAAGGTC -> GGGAAAGGTCG
CCTCCCGGACT -> CTCCCGGACTG
CCTAAAAGAAA -> CTAAAAGAAAG
CTGCCCTGAGT -> TGCCCTGAGTT
GCTATTAGAGC -> CTATTAGAGCC
CGGAGTTACTA -> GGAGTTACTAT
GAGGAACTAAC -> AGGAACTAACG
AGCCGTCATGA -> GCCGTCATGAG
TAGCGGAGTTA -> AGCGGAGTTAC
CGGTTTGGTTG -> GGTTTGGTTGC
TTTGTCTCTTG -> TTGTCTCTTGT
TTTCCGTTACT -> TTCCGTTACTG
GTTCTTGGAGG -> TTCTTGGAGGC
GCAATCCTCCT -> CAATCCTCCTG
CGTCTGCGGCT -> GTCTGCGGCTA
TCTAGATTCGC -> CTAGATTCGCG
GGAGTCCGCCC -> GAGTCCGCCCC
GAGTGTTAGGC -> AGTGTTAGGCT
GATCCCTTCAG -> ATCCCTTCAGC
GCCTCCCGGAC -> CCTCCCGGACT
ATGATTACGAT -> TGATTACGATC
CACAGAAAGCG -> ACAGAAAGCGA
TACAGGCCAGG -> ACAGGCCAGGC
AAGCTGATGAT -> AGCTGATGATT
GCATTTGTATC -> CATTTGTATCA
CATCTAGTCGG -> ATCTAGTCGGC
CCGGAGTTCTT -> CGGAGTTCTTG
TCTCGATCACT -> CTCGATCACTT
GGCGGGACAAT -> GCGGGACAATC
CTTTGTCTCTT -> TTTGTCTCTTG
CTCTTGTACAC -> TCTTGTACACG
TACACGATATC -> ACACGATATCC
CGTTTTCCGTT -> GTTTTCCGTTA
GTTAGGCTGAT -> TTAGGCTGATC
ACCACCCATGT -> CCACCCATGTG
TTGTTGTCCGA -> TGTTGTCCGAT
GCGCACAGAAA -> CGCACAGAAAG
TCCTAAGGTAG -> CCTAAGGTAGA
TCTTCACTCGA -> CTTCACTCGAT
GAGTTGAGTAC -> AGTTGAGTACC
CTCACCTCGTC -> TCACCTCGTCT
AGGCAGCCGTC -> GGCAGCCGTCA
GCAGGGAAAAG -> CAGGGAAAAGC
GCCCAGAAACA -> CCCAGAAACAT
GGAGAGGAACT -> GAGAGGAACTA
CGGACTGAGTG -> GGACTGAGTGC
TTACTCATAGA -> TACTCATAGAA
CTGATACGTAG -> TGATACGTAGC
TATCTCTAGAT -> ATCTCTAGATT
CCTCATAAGGA -> CTCATAAGGAG
CCCGGCACGGA -> CCGGCACGGAG
TCTAGTTGTAG -> CTAGTTGTAGT
AATACTTAAAT -> ATACTTAAATC
TGCGGGGTAGC -> GCGGGGTAGCA
TGTAGATTACC -> GTAGATTACCA
CTATGCTCGCC -> TATGCTCGCCT
TTGGCGCCGTT -> TGGCGCCGTTC
AAGCTGTGCCC -> AGCTGTGCCCA
AAAGAAAGTCT -> AAGAAAGTCTC
AGAAAGGCATT -> GAAAGGCATTC
GCGATCCACCT -> CGATCCACCTC
TATTGAGATAC -> ATTGAGATACA
AGCGCACAGAA -> GCGCACAGAAA
TGGGTCTAGTT -> GGGTCTAGTTG
ATGGTACAGTT -> TGGTACAGTTT
TTGTCGCTCTC -> TGTCGCTCTCT
AACGGCATGTT -> ACGGCATGTTC
GTATGCTGGTG -> TATGCTGGTGC
GAGCGCACAGA -> AGCGCACAGAA
TTCTCTTCACT -> TCTCTTCACTC
GGCACTATGCT -> GCACTATGCTC
TTCGGTGTATA -> TCGGTGTATAC
TGGTTCGGTGC -> GGTTCGGTGCT
CATTAGGGCCT -> ATTAGGGCCTC
GAGGATGCCAG -> AGGATGCCAGG
GGTAGCATATG -> GTAGCATATGC
CGTCATGATGG -> GTCATGATGGT
ACTTAAATCAA -> CTTAAATCAAT
TAGACGAAGCC -> AGACGAAGCCG
GTAGACGGCAA -> TAGACGGCAAT
CACGCCCTAAC -> ACGCCCTAACC
CTAACTGTTCT -> TAACTGTTCTC
CCTGCTTTGCG -> CTGCTTTGCGC
ATTAGAGCCTG -> TTAGAGCCTGT
TCAGGGCCCAA -> CAGGGCCCAAT
CGTACCGTACG -> GTACCGTACGA
TATATAGATCG -> ATATAGATCGG
ACGGAGCCCAG -> CGGAGCCCAGT
CCAGAAACATG -> CAGAAACATGG
TCGCTCTATTC -> CGCTCTATTCT
GATAACGTTCA -> ATAACGTTCAA
AGTCATCCTAA -> GTCATCCTAAA
GTTCGTCCTTT -> TTCGTCCTTTT
AACTAACGACG -> ACTAACGACGC
AATGCCACAGC -> ATGCCACAGCA
TCCTGCTCGCT -> CCTGCTCGCTC
GCGGGGTAGCA -> CGGGGTAGCAT
TATCCGCGCCT -> ATCCGCGCCTT
TATACGCCGAG -> ATACGCCGAGC
CCAGTGATGAT -> CAGTGATGATG
CACCCACGCTC -> ACCCACGCTCG
TACGGCGAATC -> ACGGCGAATCT
CCAATATTAGA -> CAATATTAGAG
AAGGGATGTTT -> AGGGATGTTTC
AATCCGGATAG -> ATCCGGATAGC
ACATGCCCAGA -> CATGCCCAGAA
GGTTGTTATAA -> GTTGTTATAAG
ACGAAGCCGGT -> CGAAGCCGGTA
ATGCTCGCCTC -> TGCTCGCCTCT
TTTCGGTGTAT -> TTCGGTGTATA
CCCTTCAGCTA -> CCTTCAGCTAA
ATGGTGACTGA -> TGGTGACTGAT
AAGCGGCGACT -> AGCGGCGACTA
TATGATGAGAC -> ATGATGAGACC
TGCGCGAGAGT -> GCGCGAGAGTT
ACCTCTCCACT -> CCTCTCCACTC
ACGGGACAAGA -> CGGGACAAGAA
TAGTCATCCTA -> AGTCATCCTAA
AGCGAGCGAGG -> GCGAGCGAGGT
CGCTCTAAAAT -> GCTCTAAAATT
GCAAGCCTGCT -> CAAGCCTGCTT
AGCCTGCTTTG -> GCCTGCTTTGC
GCTCGCTCTAT -> CTCGCTCTATT
GCGGGACAATC -> CGGGACAATCC
CCAGGTTATGG -> CAGGTTATGGT
TCGCTCTCTCT -> CGCTCTCTCTC
GAGCCTGTCAT -> AGCCTGTCATA
GGCATTCACTG -> GCATTCACTGA
GGCAGCCGTCA -> GCAGCCGTCAT
GATGACCGGCA -> ATGACCGGCAC
ACTTAGACTGG -> CTTAGACTGGG
GAAAGGTCGAG -> AAAGGTCGAGA
AGGGCCTCCTG -> GGGCCTCCTGT
CTGAGTTATAA -> TGAGTTATAAG
AACGTCCCGTA -> ACGTCCCGTAC
TTGTTATAAGA -> TGTTATAAGAC
ACACTGCAAGC -> CACTGCAAGCC
GAGTCATAATA -> AGTCATAATAC
TAGCGTAAAAG -> AGCGTAAAAGG
TCGATCGCACA -> CGATCGCACAC
ACAGCCTGTAA -> CAGCCTGTAAT
TACTTAAATCA -> ACTTAAATCAA
ACGGTAGTCAT -> CGGTAGTCATC
GATGGTCCAGA -> ATGGTCCAGAA
CACTTAGACTG -> ACTTAGACTGG
GGCAGGGCGGG -> GCAGGGCGGGA
CTAAAGTGTGG -> TAAAGTGTGGT
CTCGGTAGTAG -> TCGGTAGTAGA
ACCGGCACTAT -> CCGGCACTATG
GAAGCTGATGA -> AAGCTGATGAT
CGATTGCACAT -> GATTGCACATA
TGATGATGGAG -> GATGATGGAGT
TTGAGAGCGCT -> TGAGAGCGCTT
TTGCCCTAGCG -> TGCCCTAGCGT
AATCCTTTTAT -> ATCCTTTTATT
GGATAACGTTC -> GATAACGTTCA
CAGTGATGATG -> AGTGATGATGG
GCGACTAGGAT -> CGACTAGGATC
CCAACCACCCA -> CAACCACCCAT
TGCGGCTATAT -> GCGGCTATATG
CACTGCAAGCC -> ACTGCAAGCCT
GAACGTAACCT -> AACGTAACCTT
ATCCAACACAA -> TCCAACACAAA
TAACGGCATGT -> AACGGCATGTT
TCAATAGCGTC -> CAATAGCGTCT
CGGCGACTAAA -> GGCGACTAAAG
AGTTCTAACTG -> GTTCTAACTGT
CCACGGGTCAG -> CACGGGTCAGG
GAAAAGCTGTG -> AAAAGCTGTGC
CTAAGCATTCG -> TAAGCATTCGT
TCGATTGCACA -> CGATTGCACAT
CACAGTACTGC -> ACAGTACTGCC
ACGGGTCAGGC -> CGGGTCAGGCG
GACCACTTGTA -> ACCACTTGTAG
ATACGGCGAAT -> TACGGCGAATC
GTAATGAGTAA -> TAATGAGTAAA
GGCGAATCTAA -> GCGAATCTAAG
ACGCCCTAACC -> CGCCCTAACCC
CGCGCCACTCT -> GCGCCACTCTG
TATACGGCGAA -> ATACGGCGAAT
TTCGACAGCCA -> TCGACAGCCAC
CTCGCCTCTCA -> TCGCCTCTCAC
CGGGAGTCATA -> GGGAGTCATAA
TGCGTACCGTG -> GCGTACCGTGC
CAATATTAGAG -> AATATTAGAGA
CTATTAGAGCC -> TATTAGAGCCT
AGAAGTAGTCC -> GAAGTAGTCCT
GCAGGGCGGGA -> CAGGGCGGGAC
GGGCGGGACAA -> GGCGGGACAAT
GTCTCTTGTAC -> TCTCTTGTACA
TTTTCCGTTAC -> TTTCCGTTACT
GGCATGTTCGT -> GCATGTTCGTC
AAAGATACCTG -> AAGATACCTGG
GCGTCAGTACT -> CGTCAGTACTC
CACCTCTCCAC -> ACCTCTCCACT
CGCCTACAATC -> GCCTACAATCC
AAAATCCTTTT -> AAATCCTTTTA
ACCAGTGAATG -> CCAGTGAATGC
CCTGGGTCTAG -> CTGGGTCTAGT
TAGACACAGTA -> AGACACAGTAC
TTTATTCATGT -> TTATTCATGTT
GTTGTAGTACT -> TTGTAGTACTT
ATCCAAGCATA -> TCCAAGCATAC
AGGGTACACTT -> GGGTACACTTG
TAGTTCACTCG -> AGTTCACTCGG
AGATTACCATT -> GATTACCATTT
ACCGTCATGAT -> CCGTCATGATG
ACTAGGTTGTT -> CTAGGTTGTTA
GCCCAGGTTAT -> CCCAGGTTATG
TGCTCACCCAC -> GCTCACCCACG
GCGCTTACAGG -> CGCTTACAGGC
GGAGCCGCCTA -> GAGCCGCCTAC
CCTTGTACTCA -> CTTGTACTCAG
CTGCTTTGCGC -> TGCTTTGCGCT
GAGAGCGCTTA -> AGAGCGCTTAC
GATTACCATTT -> ATTACCATTTC
GGCCAGGCGAC -> GCCAGGCGACT
AATCCTCCTGC -> ATCCTCCTGCT
CCACTCCACGG -> CACTCCACGGT
TTATAAGAGTG -> TATAAGAGTGT
GTATTGAGATA -> TATTGAGATAC
ATCAGATCCAA -> TCAGATCCAAC
ACTCGATGACC -> CTCGATGACCG
CCATAGCTGCC -> CATAGCTGCCC
TCTCTCGCTTG -> CTCTCGCTTGT
TCACCTCTCCA -> CACCTCTCCAC
GGTCGTCGTGA -> GTCGTCGTGAG
GTTTTCCGTTA -> TTTTCCGTTAC
TTTGCCCTAGC -> TTGCCCTAGCG
AAGTAGTCCTA -> AGTAGTCCTAA
CATAAGGAGCC -> ATAAGGAGCCG
AGCCGGTACAG -> GCCGGTACAGG
ATGTTTCGGTG -> TGTTTCGGTGT
TAAGGTAGACA -> AAGGTAGACAC
ATTCGACAGCC -> TTCGACAGCCA
TGCAAATTGTC -> GCAAATTGTCT
GAGTTACTATT -> AGTTACTATTG
TGGTGCCTCGG -> GGTGCCTCGGT
ATGGTGCCTCG -> TGGTGCCTCGG
ACAGCACCGTC -> CAGCACCGTCA
GTCGGCTATTA -> TCGGCTATTAG
GTGCCTCCCGG -> TGCCTCCCGGA
GGTGCCGGAGT -> GTGCCGGAGTT
ATCAAGAGACC -> TCAAGAGACCA
CTACGCCGCTC -> TACGCCGCTCT
TACTCAGGGCC -> ACTCAGGGCCC
GTTTTTCGCGG -> TTTTTCGCGGT
CTGTCCAGAAA -> TGTCCAGAAAC
AGCCGCCTACA -> GCCGCCTACAA
TACTGCCCTGA -> ACTGCCCTGAC
ATTGAGAGCGC -> TTGAGAGCGCT
GAAGTTACCTA -> AAGTTACCTAG
AACTGTTCTCT -> ACTGTTCTCTC
GGCGACTAAAG -> GCGACTAAAGA
GTAGCATATGC -> TAGCATATGCG
CAACCACCCAT -> AACCACCCATG
TCGTAGACGGC -> CGTAGACGGCA
CGGCAGGGCGG -> GGCAGGGCGGG
GTAAAAGGGAT -> TAAAAGGGATG
GATGATTACGA -> ATGATTACGAT
CAAACCGCTGT -> AAACCGCTGTA
TCATCCTAAAA -> CATCCTAAAAG
CGATCGGCTCG -> GATCGGCTCGA
GCCCCCGTTGC -> CCCCCGTTGCC
CCCTAACCCCC -> CCTAACCCCCG
CCTGTCATATT -> CTGTCATATTA
GCTCACACTTA -> CTCACACTTAG
GGGTGATCCCT -> GGTGATCCCTT
TCCCGGACTGA -> CCCGGACTGAG
AGATACCTGGG -> GATACCTGGGT
CTCGGAAGTTA -> TCGGAAGTTAC
ATGCGTACCGT -> TGCGTACCGTG
GTCGTCGTGAG -> TCGTCGTGAGG
GATTCGCGTCG -> ATTCGCGTCGA
TTCAATCCAAT -> TCAATCCAATC
GGAGGGCGGAT -> GAGGGCGGATA
CTGATCCAAGC -> TGATCCAAGCA
GCATTCGTTTT -> CATTCGTTTTC
CGGGACGTCAT -> GGGACGTCATA
ACCACTTGTAG -> CCACTTGTAGA
TGTTAAATAAA -> GTTAAATAAAA
AAAAGAAAGTC -> AAAGAAAGTCT
GGTTTGGTTGC -> GTTTGGTTGCC
ACAACGTCCCG -> CAACGTCCCGT
CCCTTTCTCCT -> CCTTTCTCCTG
TGTGCAGGGAA -> GTGCAGGGAAA
ACTACGCTTCC -> CTACGCTTCCT
CTTTTATTCAT -> TTTTATTCATG
CTTGTACACGA -> TTGTACACGAT
GTGTGGTAATG -> TGTGGTAATGA
CACGCTCGGTT -> ACGCTCGGTTT
TTGCACATAAC -> TGCACATAACA
GAATCTAAGCA -> AATCTAAGCAA
GCAAGGCTCAC -> CAAGGCTCACA
CTCTAAAGTGT -> TCTAAAGTGTG
CGCAAGGGTGA -> GCAAGGGTGAT
TTTTAGTTCAC -> TTTAGTTCACT
GATCGCCCCCG -> ATCGCCCCCGT
TTAGACTGGGA -> TAGACTGGGAA
GGGCGGATAAC -> GGCGGATAACG
CCCACGCATTT -> CCACGCATTTG
CTAGTCGGCTA -> TAGTCGGCTAT
ACACAGTACTG -> CACAGTACTGC
ATGATGGTGAC -> TGATGGTGACT
ACGCATTTGTA -> CGCATTTGTAT
ACCATTTCTTC -> CCATTTCTTCG
GCGGGCCTTGT -> CGGGCCTTGTA
ACGTAACCTTG -> CGTAACCTTGT
CACCTCGTCTT -> ACCTCGTCTTT
TAAAAGGGATG -> AAAAGGGATGT
CCTTGTGCAGG -> CTTGTGCAGGG
CCAATCCGGAT -> CAATCCGGATA
GGCCCAATATT -> GCCCAATATTA
CTCGGTTTGGT -> TCGGTTTGGTT
GCTTTGCGCTA -> CTTTGCGCTAC
TACAACCATAG -> ACAACCATAGC
AAGCCGGTACA -> AGCCGGTACAG
CAGGAGCAGTG -> AGGAGCAGTGG
AGATCGGTGCC -> GATCGGTGCCT
TAGATTACCAT -> AGATTACCATT
CACTCGATGAC -> ACTCGATGACC
GCACTATGCTC -> CACTATGCTCG
CATAAAATCCT -> ATAAAATCCTT
AGTGTTAGGCT -> GTGTTAGGCTC
TGACGCGCCAC -> GACGCGCCACT
CCTCTCACCGA -> CTCTCACCGAT
GTGCCGGAGTT -> TGCCGGAGTTC
GTCAGGCGCGT -> TCAGGCGCGTA
TAAGCATTCGT -> AAGCATTCGTT
CTGATGATTAC -> TGATGATTACG
CTCCAGTGATG -> TCCAGTGATGA
AGGCTCACACT -> GGCTCACACTT
TAGAATGCCAC -> AGAATGCCACA
AGAGCGGGAGT -> GAGCGGGAGTC
CGGCACGGAGC -> GGCACGGAGCC
CCGCTCTAAAA -> CGCTCTAAAAT
GCGGCGACTAA -> CGGCGACTAAA
GCATAAGCGGC -> CATAAGCGGCG
CCTGTGCAAAT -> CTGTGCAAATT
TTAGCACAATC -> TAGCACAATCA
GCATATGCGGT -> CATATGCGGTG
ATATTAACGGC -> TATTAACGGCA
TAAGACCACTT -> AAGACCACTTG
GACGGGACAAG -> ACGGGACAAGA
ATCCCAAACCG -> TCCCAAACCGC
AGGAGCAGTGG -> GGAGCAGTGGT
TCTAGCGGAGT -> CTAGCGGAGTT
ACAATCCAAGC -> CAATCCAAGCT
GAGAGGAACTA -> AGAGGAACTAA
GGTACAGTTTT -> GTACAGTTTTT
CGTATATAGAT -> GTATATAGATC
TGTCTCTTGTA -> GTCTCTTGTAC
GGACTCACCTC -> GACTCACCTCG
CCAAACCGCTG -> CAAACCGCTGT
GTTGCCATTAG -> TTGCCATTAGC
TATATTGTTAA -> ATATTGTTAAA
AGACACAGTAC -> GACACAGTACT
CAGTGGTGCGC -> AGTGGTGCGCA
CGCCCCCGTTG -> GCCCCCGTTGC
GCTGGTGCGAT -> CTGGTGCGATC
GACGCTAAGCA -> ACGCTAAGCAT
TCGTGAGGTGT -> CGTGAGGTGTA
CAGCCTGTAAT -> AGCCTGTAATC
TTTCCCTCCAG -> TTCCCTCCAGT
TGGTTAGGCTG -> GGTTAGGCTGA
TCACACTTAGA -> CACACTTAGAC
AACACAAATGA -> ACACAAATGAT
ACCCACGCTCG -> CCCACGCTCGG
TAATTACTCAT -> AATTACTCATA
ATGGTTAGGCT -> TGGTTAGGCTG
ATACAACGTCC -> TACAACGTCCC
TTAGTTCACTC -> TAGTTCACTCG
CACAGCCTGTA -> ACAGCCTGTAA
ACTGCCCTGAC -> CTGCCCTGACG
ATCGCCCCCGT -> TCGCCCCCGTT
AGGTTATGGTG -> GGTTATGGTGC
GCCCTAGCGTC -> CCCTAGCGTCA
ATAGCGTCTGC -> TAGCGTCTGCG
CCGTACCGTAC -> CGTACCGTACG
AAGGGTGATCC -> AGGGTGATCCC
CTCGTATATAG -> TCGTATATAGA
GATACCTGGGT -> ATACCTGGGTC
TTGACTAGGTT -> TGACTAGGTTG
TGCCTCGGTAG -> GCCTCGGTAGT
ACTTGGTGCCG -> CTTGGTGCCGG
ACGGTCGTCGT -> CGGTCGTCGTG
ATATTAGAGAG -> TATTAGAGAGC
ACACAAATGAT -> CACAAATGATC
GCCTTTATCAA -> CCTTTATCAAG
TCCAGAAACGG -> CCAGAAACGGT
CCCTGACGTAC -> CCTGACGTACG
CTCGGCAGGGC -> TCGGCAGGGCG
GGCGGATAACG -> GCGGATAACGT
TACTCATAGAA -> ACTCATAGAAT
CGAGAGTTGAG -> GAGAGTTGAGT
ACGGCCCTTTC -> CGGCCCTTTCT
TGCCAGGAGCA -> GCCAGGAGCAG
GTTCACTCGGA -> TTCACTCGGAA
GACAGCACCGT -> ACAGCACCGTC
TTCTGCTTGAG -> TCTGCTTGAGC
GCACACATTAG -> CACACATTAGG
TGATCCCTTCA -> GATCCCTTCAG
TACGGGCGTGG -> ACGGGCGTGGG
GTGGGAGAGGA -> TGGGAGAGGAA
CTAAGCAAGGC -> TAAGCAAGGCT
TCCCAAACCGC -> CCCAAACCGCT
AAACCGCTGTA -> AACCGCTGTAC
GCTCGGTTTGG -> CTCGGTTTGGT
TGTGGTAATGA -> GTGGTAATGAG
GGTGACTGATA -> GTGACTGATAC
CTAAAGATACC -> TAAAGATACCT
GTGTATACGCC -> TGTATACGCCG
ATTACCATTTC -> TTACCATTTCT
GCCTCTCACCG -> CCTCTCACCGA
CCGTCATGAGG -> CGTCATGAGGG
TCGGCTATTAG -> CGGCTATTAGA
GTGAATGCGTA -> TGAATGCGTAC
TAGCGTCTGCG -> AGCGTCTGCGG
ATTACGATCGG -> TTACGATCGGC
TTAGCTGGTAT -> TAGCTGGTATG
AGTAGACCTCG -> GTAGACCTCGG
GTCTGCGGCTA -> TCTGCGGCTAT
CAGTTTTTCGC -> AGTTTTTCGCG
ATAATACTTAA -> TAATACTTAAA
ATTCGCGTCGA -> TTCGCGTCGAT
GCCCAGTTCTA -> CCCAGTTCTAA
TAGGCTCGCTC -> AGGCTCGCTCT
ATTGAGATACA -> TTGAGATACAA
GCTTTAGCGTG -> CTTTAGCGTGG
TTCTAACTGTT -> TCTAACTGTTC
AGTTACTATTG -> GTTACTATTGG
TCCAAGCTATT -> CCAAGCTATTA
ATGATGGAGTC -> TGATGGAGTCC
TGTACAAGCGT -> GTACAAGCGTC
ATGCCCAGAAA -> TGCCCAGAAAC
TTGTATGGTTA -> TGTATGGTTAG
GTCTAGTTGTA -> TCTAGTTGTAG
CAAACGGGCCC -> AAACGGGCCCA
GGCTATATGAT -> GCTATATGATG
GGTTATGGTGC -> GTTATGGTGCC
TGATGGAGTCC -> GATGGAGTCCG
ATAAGCGGCGA -> TAAGCGGCGAC
GCCATAAAATC -> CCATAAAATCC
TCATATATTGT -> CATATATTGTT
ATCCAATCCGG -> TCCAATCCGGA
AGCACAATCAG -> GCACAATCAGA
CGCACACATTA -> GCACACATTAG
TGGTGCGCAAG -> GGTGCGCAAGG
GCCTGTCATAT -> CCTGTCATATT
TTTCACTCTAA -> TTCACTCTAAA
GGTTGGCGCCG -> GTTGGCGCCGT
CAAGGGTGATC -> AAGGGTGATCC
TCCAAGCATAC -> CCAAGCATACG
TTCTTGGAGGC -> TCTTGGAGGCA
GCCGCTCTTCT -> CCGCTCTTCTG
TATCAAGAGAC -> ATCAAGAGACC
AGCACCGTCAT -> GCACCGTCATG
CATAAGCGGCG -> ATAAGCGGCGA
TGTGGTTCGGT -> GTGGTTCGGTG
CTTAAATCAAT -> TTAAATCAATA
TAGAGAGCGGG -> AGAGAGCGGGA
CCAGGCGACTA -> CAGGCGACTAG
ACTTGCACTGA -> CTTGCACTGAC
CCTGCTCACCC -> CTGCTCACCCA
CTGTACAAGCG -> TGTACAAGCGT
GTAGTCATCCT -> TAGTCATCCTA
GCTTTGTTGTC -> CTTTGTTGTCC
AGTTGTAGTAC -> GTTGTAGTACT
GCTAATTACTC -> CTAATTACTCA
AGGATGCCAGG -> GGATGCCAGGA
CTGGGAAAGGT -> TGGGAAAGGTC
ATGCTGGTGCG -> TGCTGGTGCGA
CCCATGTGGTT -> CCATGTGGTTC
CGGCTCGATCG -> GGCTCGATCGC
AGCGTCTGCGG -> GCGTCTGCGGC
AAGTGTGGTAA -> AGTGTGGTAAT
TCTCCACTCCA -> CTCCACTCCAC
CTAGCGTAAAA -> TAGCGTAAAAG
AATCCGCTTTA -> ATCCGCTTTAG
ACCGATTTGCC -> CCGATTTGCCC
ATCGGCTCGAT -> TCGGCTCGATC
AGGGTGATCCC -> GGGTGATCCCT
ATCGGTGCCTC -> TCGGTGCCTCC
AACGACGCTAA -> ACGACGCTAAG
ACCTGGGTCTA -> CCTGGGTCTAG
TCCGTTACTGA -> CCGTTACTGAA
CACTTGGTGCC -> ACTTGGTGCCG
CATAATACTTA -> ATAATACTTAA
GTCCAGAAGTA -> TCCAGAAGTAG
TCCACCTCAAA -> CCACCTCAAAC
GATCGCACACA -> ATCGCACACAT
CTCCCACGAAC -> TCCCACGAACC
TCTCGGCAGGG -> CTCGGCAGGGC
CTGAGTGCTTC -> TGAGTGCTTCT
CGGCCCTTTCT -> GGCCCTTTCTC
AAATTCGACAG -> AATTCGACAGC
TATGCTGGTGC -> ATGCTGGTGCG
CTCATAAGGAG -> TCATAAGGAGC
TTCTCTCGCTT -> TCTCTCGCTTG
CAGGGCCCAAT -> AGGGCCCAATA
TTGGCCTTGCG -> TGGCCTTGCGG
CCGGTACAGGC -> CGGTACAGGCG
AATTGTCTTGT -> ATTGTCTTGTA
TAACGACGCTA -> AACGACGCTAA
ACTCCACGGTA -> CTCCACGGTAG
TCCAGTGATGA -> CCAGTGATGAT
TTACTGAAGCT -> TACTGAAGCTG
GCGTAGTCCAA -> CGTAGTCCAAC
AGCATATGCGG -> GCATATGCGGT
CGTCGTGAGGT -> GTCGTGAGGTG
TGCGCAAGGGT -> GCGCAAGGGTG
TCAGGCGCGTA -> CAGGCGCGTAG
CGCCGAGCGCA -> GCCGAGCGCAC
TGTACTCAGGG -> GTACTCAGGGC
AGTAAATGAAC -> GTAAATGAACG
GAGCTAGACGA -> AGCTAGACGAA
TGGAGTCCGCC -> GGAGTCCGCCC
ACGGCAATCCT -> CGGCAATCCTC
AGAAACATGGT -> GAAACATGGTA
GTACCGTATTG -> TACCGTATTGA
AATTACTCATA -> ATTACTCATAG
CCCAGGTTATG -> CCAGGTTATGG
TGCTTTGTTGT -> GCTTTGTTGTC
TGATACGTAGC -> GATACGTAGCT
TCCTCCTGCTC -> CCTCCTGCTCG
CAGTACTGCCC -> AGTACTGCCCT
CGAGAACACTG -> GAGAACACTGC
GCACATAACAG -> CACATAACAGT
TTGTGCAGGGA -> TGTGCAGGGAA
TCGGTTTGGTT -> CGGTTTGGTTG
TCCACTCCACG -> CCACTCCACGG
ACTTGTAGATT -> CTTGTAGATTA
TCTAAGCAAGG -> CTAAGCAAGGC
ATGACCTCATA -> TGACCTCATAA
AGCGGAGTTAC -> GCGGAGTTACT
CCTTCAGCTAA -> CTTCAGCTAAT
CACCCATGTGG -> ACCCATGTGGT
CGCACAGAAAG -> GCACAGAAAGC
CCTCCTGTGCA -> CTCCTGTGCAA
GACGCGCCACT -> ACGCGCCACTC
GAGACCTCACC -> AGACCTCACCT
GGAGCCCAGTT -> GAGCCCAGTTC
CCTTTATCAAG -> CTTTATCAAGA
GACCAGTGAAT -> ACCAGTGAATG
AAGTTACCTAG -> AGTTACCTAGC
TTGTGATGGTC -> TGTGATGGTCC
GTCATAATACT -> TCATAATACTT
TGCCATAAAAT -> GCCATAAAATC
CGTAGACGGCA -> GTAGACGGCAA
CTCTGGACGGG -> TCTGGACGGGA
GCGTCTGCGGC -> CGTCTGCGGCT
GCTTCCTTTGT -> CTTCCTTTGTC
GTACAAGCGTC -> TACAAGCGTCT
TAAAGTGTGGT -> AAAGTGTGGTA
AAGAAAGTCTC -> AGAAAGTCTCT
TCCAACCACCC -> CCAACCACCCA
TCCTTTTATTC -> CCTTTTATTCA
TTAGGCTCGCT -> TAGGCTCGCTC
GGAGGCATAAG -> GAGGCATAAGC
TAGTTGTAGTA -> AGTTGTAGTAC
ATACGTAGCTA -> TACGTAGCTAC
ATTTCTTCGTA -> TTTCTTCGTAG
TCTGCGGCTAT -> CTGCGGCTATA
AGGCGCGTAGT -> GGCGCGTAGTC
GGATCGCCCCC -> GATCGCCCCCG
TTACAGGCCAG -> TACAGGCCAGG
ACGATATCCGC -> CGATATCCGCG
CCGGACTCACC -> CGGACTCACCT
GTTGGCGCCGT -> TTGGCGCCGTT
GGCTCGCTCTA -> GCTCGCTCTAT
CGTCAGTACTC -> GTCAGTACTCA
GGCTCGATCGC -> GCTCGATCGCA
TTCCGTTACTG -> TCCGTTACTGA
TACAACGTCCC -> ACAACGTCCCG
GTTATGGTGCC -> TTATGGTGCCT
TCGGGACGTCA -> CGGGACGTCAT
GGATGCCAGGA -> GATGCCAGGAG
GCCACTCTGGA -> CCACTCTGGAC
CAGTTCTAACT -> AGTTCTAACTG
TGCACTGACCG -> GCACTGACCGA
CAACGTCCCGT -> AACGTCCCGTA
ACGTAGCTACG -> CGTAGCTACGC
ATGTTCGTCCT -> TGTTCGTCCTT
AAATCAATAGC -> AATCAATAGCG
ATGCCAGGAGC -> TGCCAGGAGCA
AAGGTAGACAC -> AGGTAGACACA
AACGTTCAATC -> ACGTTCAATCC
AGGGCGGGACA -> GGGCGGGACAA
TCTATTCTCTT -> CTATTCTCTTC
GTCCTAAGGTA -> TCCTAAGGTAG
TACACTTGGTG -> ACACTTGGTGC
ACCTAGCGTAA -> CCTAGCGTAAA
GTCATGAGGGT -> TCATGAGGGTA
ATTGTTAAATA -> TTGTTAAATAA
CTCCCGGACTG -> TCCCGGACTGA
TTCGTAGACGG -> TCGTAGACGGC
TGGTTGCCATA -> GGTTGCCATAA
ATCGCACACAT -> TCGCACACATT
TCATAGAATGC -> CATAGAATGCC
GCATACATGCC -> CATACATGCCC
TCTGCTTGAGC -> CTGCTTGAGCT
CCATGTGGTTC -> CATGTGGTTCG
CTGACGTACGG -> TGACGTACGGG
TATCATCTAGT -> ATCATCTAGTC
CGTTACTGAAG -> GTTACTGAAGC
AAGAGTGTTAG -> AGAGTGTTAGG
TAACAGTGCCT -> AACAGTGCCTT
ATAGCATATCC -> TAGCATATCCG
CCCAAACCGCT -> CCAAACCGCTG
CGACTAGGATC -> GACTAGGATCG
ACTGAAGCTGA -> CTGAAGCTGAT
TTTTTCGCGGT -> TTTTCGCGGTT
TGAAGCTGATG -> GAAGCTGATGA
ACGATCGGCTC -> CGATCGGCTCG
ACAGGCGACAG -> CAGGCGACAGC
GCGCAAGGGTG -> CGCAAGGGTGA
GAGTCCGCCCC -> AGTCCGCCCCA
TCACTTGCACT -> CACTTGCACTG
TGTTAGGCTCG -> GTTAGGCTCGC
AAGCGTCTCGA -> AGCGTCTCGAT
CCTTTTCCCTC -> CTTTTCCCTCC
AGTACTGCCCT -> GTACTGCCCTG
TCCTGTGCAAA -> CCTGTGCAAAT
AGCTGTGCCCA -> GCTGTGCCCAG
GCTAAGCATTC -> CTAAGCATTCG
TGCCTTTATCA -> GCCTTTATCAA
TGCCCTGACGT -> GCCCTGACGTA
GGACGGGACAA -> GACGGGACAAG
ACCGAAGATCA -> CCGAAGATCAC
AAAAGCTGTGC -> AAAGCTGTGCC
CCACCCATGTG -> CACCCATGTGG
GTAAATGAACG -> TAAATGAACGT
ACGCCGCTCTT -> CGCCGCTCTTC
CTGACGCGCCA -> TGACGCGCCAC
AGATCACCTCG -> GATCACCTCGT
GCGTAAAAGGG -> CGTAAAAGGGA
CTTTGTTGTCC -> TTTGTTGTCCG
AAAATTGAGAG -> AAATTGAGAGC
GAGCCGCCTAC -> AGCCGCCTACA
ACAGCCACGGG -> CAGCCACGGGT
TCACTCGATGA -> CACTCGATGAC
TACTATTGGTA -> ACTATTGGTAC
TACGTAGCTAC -> ACGTAGCTACG
CCAGTGAATGC -> CAGTGAATGCG
TACTCACAGCC -> ACTCACAGCCT
AAGATACCTGG -> AGATACCTGGG
AAGCGAGCGAG -> AGCGAGCGAGG
GAAACATGGTA -> AAACATGGTAC
TTGATGACCTC -> TGATGACCTCA
TTATGGTGCCT -> TATGGTGCCTC
GATACGTAGCT -> ATACGTAGCTA
TGATGATTACG -> GATGATTACGA
CCTCTCCACTC -> CTCTCCACTCC
TTATCAAGAGA -> TATCAAGAGAC
TCATGATGGTG -> CATGATGGTGA
CCGCGTTTACA -> CGCGTTTACAA
AACCGAAGATC -> ACCGAAGATCA
TCCCACGAACC -> CCCACGAACCG
TGATGGTGACT -> GATGGTGACTG
AGAGCCTGTCA -> GAGCCTGTCAT
CAGGGCGGGAC -> AGGGCGGGACA
TTATTCATGTT -> TATTCATGTTT
TGATTGTCGCT -> GATTGTCGCTC
CTGGTGCGATC -> TGGTGCGATCC
AGCGCTTACAG -> GCGCTTACAGG
CAAGCGTCTCG -> AAGCGTCTCGA
GAAGTAGTCCT -> AAGTAGTCCTA
CTCTCTCTCGG -> TCTCTCTCGGC
TCTCTAGATTC -> CTCTAGATTCG
TTGGTACCGCT -> TGGTACCGCTC
ATCCTCCTGCT -> TCCTCCTGCTC
ACGTTCAATCC -> CGTTCAATCCA
CTTGGAGGCAT -> TTGGAGGCATA
TAAGCAAGGCT -> AAGCAAGGCTC
CCACTCTGGAC -> CACTCTGGACG
ATTTGTATCAT -> TTTGTATCATC
GGGCCTTGTAC -> GGCCTTGTACT
CAATCCCAAAC -> AATCCCAAACC
AGTCCAACCAC -> GTCCAACCACC
ACTCTGGACGG -> CTCTGGACGGG
AGGCATAAGCG -> GGCATAAGCGG
CTTTGCGCTAC -> TTTGCGCTACT
GAGTAAATGAA -> AGTAAATGAAC
GGGGTAGCATA -> GGGTAGCATAT
AGGATCGCCCC -> GGATCGCCCCC
GTATGGTTAGG -> TATGGTTAGGC
TCACCTCGTAT -> CACCTCGTATA
AGACCTCACCT -> GACCTCACCTC
GAGAGAAAGGC -> AGAGAAAGGCA
CGTCTTTTAGT -> GTCTTTTAGTT
TGGTAATGAGT -> GGTAATGAGTA
GGCTATTAGAG -> GCTATTAGAGC
ATATCCGCGCC -> TATCCGCGCCT
ACGGGCGTGGG -> CGGGCGTGGGA
CGAAGCCGGTA -> GAAGCCGGTAC
CCAGAAGTAGT -> CAGAAGTAGTC
AGACCTCGGTC -> GACCTCGGTCC
CTCTTCACTCG -> TCTTCACTCGA
TTCCCTCCAGT -> TCCCTCCAGTG
TCAGATCCAAC -> CAGATCCAACA
GATGAGACCTC -> ATGAGACCTCA
GTTTGGTTGCC -> TTTGGTTGCCA
TCGTCCTTTTC -> CGTCCTTTTCC
GGAAGTTACCT -> GAAGTTACCTA
CTCTCTCGGCA -> TCTCTCGGCAG
CACCTCAAACG -> ACCTCAAACGG
TATAAGACCAC -> ATAAGACCACT
CCCTCCAGTGA -> CCTCCAGTGAT
GTTGTCCGATG -> TTGTCCGATGA
TCAAGAGACCA -> CAAGAGACCAG
CGGGCCCACGC -> GGGCCCACGCA
CTCTCCACTCC -> TCTCCACTCCA
TTCGCGTCGAT -> TCGCGTCGATT
ATAGAATGCCA -> TAGAATGCCAC
TAGATTCGCGT -> AGATTCGCGTC
CGCTAAGCATT -> GCTAAGCATTC
CGTAAAAGGGA -> GTAAAAGGGAT
AATGAGTAAAT -> ATGAGTAAATG
ATACATGCCCA -> TACATGCCCAG
TAAATCAATAG -> AAATCAATAGC
GTCCGATGAGG -> TCCGATGAGGC
GTAACCTTGTG -> TAACCTTGTGC
TTAAATAAAAA -> TAAATAAAAAA
GATGGTGACTG -> ATGGTGACTGA
CGGCGAATCTA -> GGCGAATCTAA
AAAATTCGACA -> AAATTCGACAG
GTGCTTTGTTG -> TGCTTTGTTGT
GTTAGGCTCGC -> TTAGGCTCGCT
TTGTAGATTAC -> TGTAGATTACC
AAAAGGGATGT -> AAAGGGATGTT
TCTCCTGCTCA -> CTCCTGCTCAC
CCTCGGTAGTA -> CTCGGTAGTAG
CGTCATATATT -> GTCATATATTG
TTTGCGCTACT -> TTGCGCTACTA
CACCGATTTGC -> ACCGATTTGCC
CGATGAGGCAG -> GATGAGGCAGC
TGATGACCTCA -> GATGACCTCAT
CTCGATCGCAC -> TCGATCGCACA
CCCGTACCGTA -> CCGTACCGTAC
TGCTGGTGCGA -> GCTGGTGCGAT
CTTGAGCTAGA -> TTGAGCTAGAC
TTGTCTTGTAT -> TGTCTTGTATG
GATGAGGCAGC -> ATGAGGCAGCC
AAATTGAGAGC -> AATTGAGAGCG
TACGCCGCTCT -> ACGCCGCTCTT
AATCCAATCCG -> ATCCAATCCGG
ATAAGACCACT -> TAAGACCACTT
CAGTACTCACA -> AGTACTCACAG
TGTTCGTCCTT -> GTTCGTCCTTT
CGGTACAGGCG -> GGTACAGGCGA
ATTAGGGCCTC -> TTAGGGCCTCC
GAGGCATAAGC -> AGGCATAAGCG
AGAGTTGAGTA -> GAGTTGAGTAC
AACCCCCGGAC -> ACCCCCGGACT
GAGTTATAAGA -> AGTTATAAGAG
CACGGTAGTCA -> ACGGTAGTCAT
TCTTTTAGTTC -> CTTTTAGTTCA
GTCCCCGGCAC -> TCCCCGGCACG
TCGCCCCCGTT -> CGCCCCCGTTG
GAGAGTTGAGT -> AGAGTTGAGTA
TGACCGAGAGA -> GACCGAGAGAA
TGTAGTACTTG -> GTAGTACTTGG
CTGCTCACCCA -> TGCTCACCCAC
CCGATTTGCCC -> CGATTTGCCCT
CACACATTAGG -> ACACATTAGGG
CCTAAGGTAGA -> CTAAGGTAGAC
CTAATTACTCA -> TAATTACTCAT
GGGTACACTTG -> GGTACACTTGG
TCCCTTCAGCT -> CCCTTCAGCTA
TAGTCCTAAGG -> AGTCCTAAGGT
ACAGTACTGCC -> CAGTACTGCCC
GGACAATCCCA -> GACAATCCCAA
TGTATACGCCG -> GTATACGCCGA
ATCCAGTTGGA -> TCCAGTTGGAG
ACCGAGAGAAA -> CCGAGAGAAAG
GTTATAAGACC -> TTATAAGACCA
ACGGGCCCACG -> CGGGCCCACGC
GCTCGATCGCA -> CTCGATCGCAC
AAGCATTCGTT -> AGCATTCGTTT
TACTACGCTTC -> ACTACGCTTCC
AGGTAGACACA -> GGTAGACACAG
TGTGATGGTCC -> GTGATGGTCCA
GAAAGTCTCTG -> AAAGTCTCTGT
ACGTCCCGTAC -> CGTCCCGTACC
TGGAGGGCGGA -> GGAGGGCGGAT
GCACGGAGCCC -> CACGGAGCCCA
CCAGGAGCAGT -> CAGGAGCAGTG
AGCCACGGGTC -> GCCACGGGTCA
CCGAGAGAAAG -> CGAGAGAAAGG
ACCTCACCTCT -> CCTCACCTCTC
ACATGGTACAG -> CATGGTACAGT
AGTACTCACAG -> GTACTCACAGC
AGACGGCAATC -> GACGGCAATCC
TGCTTTGCGCT -> GCTTTGCGCTA
TGGTGCCGGAG -> GGTGCCGGAGT
GTCAGTACTCA -> TCAGTACTCAC
TGACGTACGGG -> GACGTACGGGC
ACTGGGAAAGG -> CTGGGAAAGGT
GTAGTAGACCT -> TAGTAGACCTC
TTCACTCGATG -> TCACTCGATGA
CCGGCACGGAG -> CGGCACGGAGC
ATTGGTACCGC -> TTGGTACCGCT
TTAAATCAATA -> TAAATCAATAG
ATAACGTTCAA -> TAACGTTCAAT
AAACGGGCCCA -> AACGGGCCCAC
ATGTTTCACTC -> TGTTTCACTCT
CGCCGCTCTTC -> GCCGCTCTTCT
GGAGTTCTTGG -> GAGTTCTTGGA
CAGTTGGAGGG -> AGTTGGAGGGC
CATTTGTATCA -> ATTTGTATCAT
CAACCATAGCT -> AACCATAGCTG
CCCCAGAGGAT -> CCCAGAGGATG
TGCCTCCCGGA -> GCCTCCCGGAC
TGTCCGATGAG -> GTCCGATGAGG
TCTCTTCACTC -> CTCTTCACTCG
TCCAATCCGGA -> CCAATCCGGAT
GATCACCTCGT -> ATCACCTCGTA
AGAAAGTCTCT -> GAAAGTCTCTG
GACTAAAGATA -> ACTAAAGATAC
CGTGAGGTGTA -> GTGAGGTGTAT
AGGGAAAAGCT -> GGGAAAAGCTG
ATAAGAGTGTT -> TAAGAGTGTTA
CGGTGCCTCCC -> GGTGCCTCCCG
CATGTTCGTCC -> ATGTTCGTCCT
AAAGGTCGAGA -> AAGGTCGAGAA
AGTCATAATAC -> GTCATAATACT
GCTTCTTGAGC -> CTTCTTGAGCG
TACCTGGGTCT -> ACCTGGGTCTA
GGAGCAGTGGT -> GAGCAGTGGTG
GTACACTTGGT -> TACACTTGGTG
ATCCGCTTTAG -> TCCGCTTTAGC
GCCCACGCATT -> CCCACGCATTT
GTGTATACGGC -> TGTATACGGCG
TAAAATTGAGA -> AAAATTGAGAG
TAAATAAAAAA -> AAATAAAAAAC
ATCACCTCGTA -> TCACCTCGTAT
TACCGTGCGCG -> ACCGTGCGCGA
CACATTAGGGC -> ACATTAGGGCC
GTCCAACCACC -> TCCAACCACCC
CCAAGCTATTA -> CAAGCTATTAG
AGGAGCCGCCT -> GGAGCCGCCTA
GTTGAGTACCG -> TTGAGTACCGT
TGTAATCACGC -> GTAATCACGCC
CGGGACAATCC -> GGGACAATCCC
AGGTCGAGAAC -> GGTCGAGAACA
GCCCTGACGTA -> CCCTGACGTAC
CAGGCGACAGC -> AGGCGACAGCA
TGCTTCTTGAG -> GCTTCTTGAGC
ACTCAGGGCCC -> CTCAGGGCCCA
GGTACCGCTCT -> GTACCGCTCTA
CCTCCAGTGAT -> CTCCAGTGATG
TGGTGCGATCC -> GGTGCGATCCA
CTCGCTTGTGA -> TCGCTTGTGAT
TATGCGGTGTG -> ATGCGGTGTGA
TGTCCAGAAAC -> GTCCAGAAACG
TATCCGCGTTT -> ATCCGCGTTTA
TACCATTTCTT -> ACCATTTCTTC
CGCTCCCACGA -> GCTCCCACGAA
TATATGATGAG -> ATATGATGAGA
CGTGCGCGAGA -> GTGCGCGAGAG
CACTGACCGAG -> ACTGACCGAGA
TTATAAGACCA -> TATAAGACCAC
GTGCCTCGGTA -> TGCCTCGGTAG
CGTCCCGTACC -> GTCCCGTACCG
ACACTTGGTGC -> CACTTGGTGCC
ATATATTGTTA -> TATATTGTTAA
CCGCCCCAGAG -> CGCCCCAGAGG
TTCTAGCGGAG -> TCTAGCGGAGT
TCGTCGTGAGG -> CGTCGTGAGGT
TATAAGAGTGT -> ATAAGAGTGTT
TTCGTCCTTTT -> TCGTCCTTTTC
CTCGTCTTTTA -> TCGTCTTTTAG
TAGTACTTGGC -> AGTACTTGGCC
AGTCGGCTATT -> GTCGGCTATTA
GAGAAAGGCAT -> AGAAAGGCATT
GCCTTGTACTC -> CCTTGTACTCA
GGTTCGGTGCT -> GTTCGGTGCTT
TCACAGCCTGT -> CACAGCCTGTA
TAACCTTGTGC -> AACCTTGTGCA
TGCTCGCCTCT -> GCTCGCCTCTC
GCGCCACTCTG -> CGCCACTCTGG
CCGTATTGAGA -> CGTATTGAGAT
TTTCTTCGTAG -> TTCTTCGTAGA
ACTAGGATCGC -> CTAGGATCGCC
GCCGAGCGCAC -> CCGAGCGCACA
GGGATGTTTCA -> GGATGTTTCAC
AAGACCACTTG -> AGACCACTTGT
CCGTCATGATG -> CGTCATGATGG
TCATCTAGTCG -> CATCTAGTCGG
TTTGTTGTCCG -> TTGTTGTCCGA
TCCGCCCCAGA -> CCGCCCCAGAG
GTGTGATTGTC -> TGTGATTGTCG
CATTTCTTCGT -> ATTTCTTCGTA
TGATGGTCCAG -> GATGGTCCAGA
TCCTTTTCCCT -> CCTTTTCCCTC
TCGACAGCCAC -> CGACAGCCACG
TGCACATAACA -> GCACATAACAG
TCTTGTATGGT -> CTTGTATGGTT
TCAATCCAATC -> CAATCCAATCC
GGGAGTCATAA -> GGAGTCATAAT
TCACGCCCTAA -> CACGCCCTAAC
CTTGGCCTTGC -> TTGGCCTTGCG
TCTTCTGTTTG -> CTTCTGTTTGA
TCGAGAACACT -> CGAGAACACTG
CGCTACTACGC -> GCTACTACGCT
TTGCCATTAGC -> TGCCATTAGCA
GCGCCTTTCTG -> CGCCTTTCTGC
TTGCCATAAAA -> TGCCATAAAAT
CTGCGGCTATA -> TGCGGCTATAT
ACTAAAGATAC -> CTAAAGATACC
TGAGGGTACAC -> GAGGGTACACT
CACTCGGAAGT -> ACTCGGAAGTT
GTAGACACAGT -> TAGACACAGTA
GGTAGTCATCC -> GTAGTCATCCT
ATGAACGTAAC -> TGAACGTAACC
TTGGAGGGCGG -> TGGAGGGCGGA
ACGGCATGTTC -> CGGCATGTTCG
AGCGAGGTTGG -> GCGAGGTTGGC
CTATTCTCTTC -> TATTCTCTTCA
CAAATGATCGG -> AAATGATCGGG
TGAGCGGGCCT -> GAGCGGGCCTT
CTTCACTCGAT -> TTCACTCGATG
ACTCTAAAGTG -> CTCTAAAGTGT
CTAACGACGCT -> TAACGACGCTA
CACAAATGATC -> ACAAATGATCG
AATCCCAAACC -> ATCCCAAACCG
GTTCAATCCAA -> TTCAATCCAAT
AAGCATACGGC -> AGCATACGGCC
ATCTAGTCGGC -> TCTAGTCGGCT
CAGGCGCGTAG -> AGGCGCGTAGT
CGTCCTTTTCC -> GTCCTTTTCCC
GTGGTTCGGTG -> TGGTTCGGTGC
GTGATTGTCGC -> TGATTGTCGCT
TTGAGCTAGAC -> TGAGCTAGACG
TCTAGTCGGCT -> CTAGTCGGCTA
CTGGACGGGAC -> TGGACGGGACA
ACATAACAGTG -> CATAACAGTGC
TTACGATCGGC -> TACGATCGGCT
TGCCATTAGCA -> GCCATTAGCAC
CAGAAACGGTC -> AGAAACGGTCG
ATTGTCTTGTA -> TTGTCTTGTAT
GTGATCCCTTC -> TGATCCCTTCA
GTACTCACAGC -> TACTCACAGCC
TGTATGGTTAG -> GTATGGTTAGG
ACCTCAAACGG -> CCTCAAACGGG
ATTGTCGCTCT -> TTGTCGCTCTC
GCCCCAGAGGA -> CCCCAGAGGAT
CGGACTCACCT -> GGACTCACCTC
CATGAGGGTAC -> ATGAGGGTACA
CAAGCTATTAG -> AAGCTATTAGC
GGGAAAAGCTG -> GGAAAAGCTGT
ACCTTGTGCAG -> CCTTGTGCAGG
GTTAAATAAAA -> TTAAATAAAAA
GTCCTTTTCCC -> TCCTTTTCCCT
TTCTCCTGCTC -> TCTCCTGCTCA
GATTGCACATA -> ATTGCACATAA
CCCCGGCACGG -> CCCGGCACGGA
GCGCGTAGTCC -> CGCGTAGTCCA
TCGCGTCGATT -> CGCGTCGATTG
CCCGTTGCCAT -> CCGTTGCCATT
CCTCGTCTTTT -> CTCGTCTTTTA
TATGCTCGCCT -> ATGCTCGCCTC
ATAAAATCCTT -> TAAAATCCTTT
GAGCGCTTACA -> AGCGCTTACAG
TCTTGAGCGGG -> CTTGAGCGGGC
GGTCCCCGGCA -> GTCCCCGGCAC
AGACGAAGCCG -> GACGAAGCCGG
ATATTGTTAAA -> TATTGTTAAAT
GAAGATCACCT -> AAGATCACCTC
ACTGACCGAGA -> CTGACCGAGAG
TAGTCGGCTAT -> AGTCGGCTATT
CTTCGTAGACG -> TTCGTAGACGG
GCGTTTACAAC -> CGTTTACAACC
ACTATTGGTAC -> CTATTGGTACC
CCTTTGTCTCT -> CTTTGTCTCTT
GCTGATGATTA -> CTGATGATTAC
GACAATCCCAA -> ACAATCCCAAA
CAATCCTCCTG -> AATCCTCCTGC
ACCTCATAAGG -> CCTCATAAGGA
GGGTCAGGCGC -> GGTCAGGCGCG
ACCTCGGTCCC -> CCTCGGTCCCC
GGCGCGTAGTC -> GCGCGTAGTCC
AGGCATTCACT -> GGCATTCACTG
GCGTCGATTGC -> CGTCGATTGCA
TCCGCGCCTTT -> CCGCGCCTTTC
TGAGTTATAAG -> GAGTTATAAGA
ACTGACGCGCC -> CTGACGCGCCA
CTATATGATGA -> TATATGATGAG
GTACTTGGCCT -> TACTTGGCCTT
ACTCACAGCCT -> CTCACAGCCTG
GGCCTTGTACT -> GCCTTGTACTC
CATCCTAAAAG -> ATCCTAAAAGA
ACCGCTGTACA -> CCGCTGTACAA
CCGCCTACAAT -> CGCCTACAATC
TACAATCCAAG -> ACAATCCAAGC
CTGCAAGCCTG -> TGCAAGCCTGC
CTGTTCTCTCG -> TGTTCTCTCGC
CATGTGGTTCG -> ATGTGGTTCGG
CTTCTGTTTGA -> TTCTGTTTGAT
CACTGCAAAAT -> ACTGCAAAATT
AAGAGACCAGT -> AGAGACCAGTG
TAGTCCAACCA -> AGTCCAACCAC
CCCACGAACCG -> CCACGAACCGA
CCGAGCGCACA -> CGAGCGCACAG
CAAGCCTGCTT -> AAGCCTGCTTT
TCAAACGGGCC -> CAAACGGGCCC
CGTACCGTGCG -> GTACCGTGCGC
AAACATGGTAC -> AACATGGTACA
TACGGCCCTTT -> ACGGCCCTTTC
CGTACGAACAC -> GTACGAACACT
TAGCATATGCG -> AGCATATGCGG
GGTGTGATTGT -> GTGTGATTGTC
TTAACGGCATG -> TAACGGCATGT
TGTCTTGTATG -> GTCTTGTATGG
GAGAACACTGC -> AGAACACTGCA
TCGGTAGTAGA -> CGGTAGTAGAC
TCTAACTGTTC -> CTAACTGTTCT
GCTTGTGATGG -> CTTGTGATGGT
GGTGTATACGC -> GTGTATACGCC
CATATGCGGTG -> ATATGCGGTGT
CGGCAATCCTC -> GGCAATCCTCC
CACTCTGGACG -> ACTCTGGACGG
ACAGCATACAT -> CAGCATACATG
TGTTTGATGAC -> GTTTGATGACC
CCATTTCTTCG -> CATTTCTTCGT
GAGTACCGTAT -> AGTACCGTATT
ATTAACGGCAT -> TTAACGGCATG
ATGATGAGACC -> TGATGAGACCT
GATGACCTCAT -> ATGACCTCATA
TTAGGGCCTCC -> TAGGGCCTCCT
ATTTGCCCTAG -> TTTGCCCTAGC
TTGCGGGGTAG -> TGCGGGGTAGC
TGAGTAAATGA -> GAGTAAATGAA
GGTGTATACGG -> GTGTATACGGC
TCGGTGCCTCC -> CGGTGCCTCCC
AGTCCGCCCCA -> GTCCGCCCCAG
TCTCGCTTGTG -> CTCGCTTGTGA
CTCTAGATTCG -> TCTAGATTCGC
TGGACGGGACA -> GGACGGGACAA
CTTGTGATGGT -> TTGTGATGGTC
GTAGTCCTAAG -> TAGTCCTAAGG
TAAGAGTGTTA -> AAGAGTGTTAG
GTGCAAATTGT -> TGCAAATTGTC
CCCAGAGGATG -> CCAGAGGATGC
TCTCTTGTACA -> CTCTTGTACAC
GTGAGGTGTAT -> TGAGGTGTATA
GAGTGCTTCTT -> AGTGCTTCTTG
TAGCTACGCCG -> AGCTACGCCGC
GCGGAGTTACT -> CGGAGTTACTA
CTCAAACGGGC -> TCAAACGGGCC
AGTTGGAGGGC -> GTTGGAGGGCG
CCCGGACTCAC -> CCGGACTCACC
GTTGCCATAAA -> TTGCCATAAAA
CGTAGCTACGC -> GTAGCTACGCC
CTCAGGGCCCA -> TCAGGGCCCAA
TTTAGCGTGGT -> TTAGCGTGGTA
CTAGGTTGTTA -> TAGGTTGTTAT
TCATGAGGGTA -> CATGAGGGTAC
TACCTAGCGTA -> ACCTAGCGTAA
TCATAAGGAGC -> CATAAGGAGCC
GCACAGAAAGC -> CACAGAAAGCG
TGCAAGCCTGC -> GCAAGCCTGCT
CAGTGAATGCG -> AGTGAATGCGT
CATTCGTTTTC -> ATTCGTTTTCC
CCTGAGTTATA -> CTGAGTTATAA
CTCGCTCTATT -> TCGCTCTATTC
ATGACCGGCAC -> TGACCGGCACT
ATACGCCGAGC -> TACGCCGAGCG
ATAGATCGGTG -> TAGATCGGTGC
ATCCCTTCAGC -> TCCCTTCAGCT
CCGTTGCCATT -> CGTTGCCATTA
CGCATTTGTAT -> GCATTTGTATC
AGGGCCCAATA -> GGGCCCAATAT
CATATTAACGG -> ATATTAACGGC
GCCCTTTCTCC -> CCCTTTCTCCT
GACCTCACCTC -> ACCTCACCTCT
AGCGGGCCTTG -> GCGGGCCTTGT
CAAAATTCGAC -> AAAATTCGACA
GGGCGTGGGAG -> GGCGTGGGAGA
TGTATCATCTA -> GTATCATCTAG
AGTTTTTCGCG -> GTTTTTCGCGG
TTTTATTCATG -> TTTATTCATGT
GTGGTATCTCT -> TGGTATCTCTA
AGCTAGACGAA -> GCTAGACGAAG
GTCCCGTACCG -> TCCCGTACCGT
GGTCTAGTTGT -> GTCTAGTTGTA
TCACTCGGAAG -> CACTCGGAAGT
TAAGCGGCGAC -> AAGCGGCGACT
ATTACTCATAG -> TTACTCATAGA
CCGTACGAACA -> CGTACGAACAC
AGAGAGCGGGA -> GAGAGCGGGAG
TCCGCGTTTAC -> CCGCGTTTACA
CGTAGTCCAAC -> GTAGTCCAACC
CACTTGCACTG -> ACTTGCACTGA
TCCAACACAAA -> CCAACACAAAT
CTGGTATGCTG -> TGGTATGCTGG
CACAATCAGAT -> ACAATCAGATC
CTTGTATGGTT -> TTGTATGGTTA
TAGTAGACCTC -> AGTAGACCTCG
TTCAGCTAATT -> TCAGCTAATTA
CTCTCACCGAT -> TCTCACCGATT
GGTACAGGCGA -> GTACAGGCGAC
GTCTCTGTCCA -> TCTCTGTCCAG
GGTGATCCCTT -> GTGATCCCTTC
GAATCCAGTTG -> AATCCAGTTGG
GCCCTAACCCC -> CCCTAACCCCC
GCCACAGCATA -> CCACAGCATAC
AATGCGTACCG -> ATGCGTACCGT
TAACTGTTCTC -> AACTGTTCTCT
GCTGTACAAGC -> CTGTACAAGCG
GTACTGCCCTG -> TACTGCCCTGA
TCCCTCCAGTG -> CCCTCCAGTGA
GCTATATGATG -> CTATATGATGA
CCCAGTTCTAA -> CCAGTTCTAAC
AAGTCTCTGTC -> AGTCTCTGTCC
CCACGAACCGA -> CACGAACCGAA
AAAGGGATGTT -> AAGGGATGTTT
TTGTATCATCT -> TGTATCATCTA
CTCGGTCCCCG -> TCGGTCCCCGG
GGTAGACACAG -> GTAGACACAGT
TGTTTCGGTGT -> GTTTCGGTGTA
AGTCTCTGTCC -> GTCTCTGTCCA
TACCGCTCTAA -> ACCGCTCTAAA
GTTCGGTGCTT -> TTCGGTGCTTT
AGCTAATTACT -> GCTAATTACTC
GTAGTACTTGG -> TAGTACTTGGC
ACTATGCTCGC -> CTATGCTCGCC
GTCGATTGCAC -> TCGATTGCACA
ATCTAAGCAAG -> TCTAAGCAAGG
GCCAGGAGCAG -> CCAGGAGCAGT
ACAAATGATCG -> CAAATGATCGG
TTGTTAAATAA -> TGTTAAATAAA
AGCGGGAGTCA -> GCGGGAGTCAT
GGCACGGAGCC -> GCACGGAGCCC
GACCTCGGTCC -> ACCTCGGTCCC
ATCCAAGCTAT -> TCCAAGCTATT
GCAGTGGTGCG -> CAGTGGTGCGC
TATTAGCTGGT -> ATTAGCTGGTA
CATGGTACAGT -> ATGGTACAGTT
AGACCAGTGAA -> GACCAGTGAAT
CAGGGAAAAGC -> AGGGAAAAGCT
ATCGGGACGTC -> TCGGGACGTCA
TACGCTTCCTT -> ACGCTTCCTTT
GGTACACTTGG -> GTACACTTGGT
CGCCTTTCTGC -> GCCTTTCTGCT
GGCAATCCTCC -> GCAATCCTCCT
ATTCGTTTTCC -> TTCGTTTTCCG
GCCATTAGCAC -> CCATTAGCACA
AGCTATTAGCT -> GCTATTAGCTG
CGGTCCCCGGC -> GGTCCCCGGCA
GGCTCACACTT -> GCTCACACTTA
GTACGAACACT -> TACGAACACTG
GTTGGAGGGCG -> TTGGAGGGCGG
CCTCAAACGGG -> CTCAAACGGGC
ACGACGCTAAG -> CGACGCTAAGC
GTACTCAGGGC -> TACTCAGGGCC
AGAATCCAGTT -> GAATCCAGTTG
AACATGGTACA -> ACATGGTACAG
AGTGATGATGG -> GTGATGATGGA
CGCCCTAACCC -> GCCCTAACCCC
CTTGTACTCAG -> TTGTACTCAGG
CTCCTGCTCGC -> TCCTGCTCGCT
CTAGACGAAGC -> TAGACGAAGCC
CTTTTCCCTCC -> TTTTCCCTCCA
TCACCGATTTG -> CACCGATTTGC
AGCAAGGCTCA -> GCAAGGCTCAC
CATATATTGTT -> ATATATTGTTA
GACAAGAATCC -> ACAAGAATCCA
TAGGATCGCCC -> AGGATCGCCCC
TCTAAAGTGTG -> CTAAAGTGTGG
TGAGAGCGCTT -> GAGAGCGCTTA
TAATACTTAAA -> AATACTTAAAT
GGGCCTCCTGT -> GGCCTCCTGTG
ACTGCAAGCCT -> CTGCAAGCCTG
GAAAGGCATTC -> AAAGGCATTCA
AATGATCGGGA -> ATGATCGGGAC
GCCAGGCGACT -> CCAGGCGACTA
GCGAATCTAAG -> CGAATCTAAGC
ATTCTCTTCAC -> TTCTCTTCACT
TGGTATCTCTA -> GGTATCTCTAG
TTAGCGTGGTA -> TAGCGTGGTAT
TCACCCACGCT -> CACCCACGCTC
GGATAGCATAT -> GATAGCATATC
ATATAGATCGG -> TATAGATCGGT
CGCGCCTTTCT -> GCGCCTTTCTG
AGCCTGTAATC -> GCCTGTAATCA
ATTAGAGAGCG -> TTAGAGAGCGG
TCGTTTTCCGT -> CGTTTTCCGTT
CCACAGCATAC -> CACAGCATACA
GGCGCCGTTCT -> GCGCCGTTCTA
TTCCTTTGTCT -> TCCTTTGTCTC
ACGGCGAATCT -> CGGCGAATCTA
GTCTCGATCAC -> TCTCGATCACT
CACATAACAGT -> ACATAACAGTG
AACCATAGCTG -> ACCATAGCTGC
CGCTCGGTTTG -> GCTCGGTTTGG
TTGCGCTACTA -> TGCGCTACTAC
ATGATCGGGAC -> TGATCGGGACG
TTCACTCGGAA -> TCACTCGGAAG
GACTAGGTTGT -> ACTAGGTTGTT
CTAGATTCGCG -> TAGATTCGCGT
GCACAATCAGA -> CACAATCAGAT
AACGGGCCCAC -> ACGGGCCCACG
CTTCCTTTGTC -> TTCCTTTGTCT
CTTCTTGAGCG -> TTCTTGAGCGG
CACCTCGTATA -> ACCTCGTATAT
GCCTACAATCC -> CCTACAATCCA
TCGGAAGTTAC -> CGGAAGTTACC
TCACCTCGTCT -> CACCTCGTCTT
CTCACACTTAG -> TCACACTTAGA
AACCTTGTGCA -> ACCTTGTGCAG
TCCACGGTAGT -> CCACGGTAGTC
GCCTGCTTTGC -> CCTGCTTTGCG
TGACTAGGTTG -> GACTAGGTTGT
CTAGGATCGCC -> TAGGATCGCCC
TAACCCCCGGA -> AACCCCCGGAC
CCTAGCGTCAG -> CTAGCGTCAGT
TTGAGCGGGCC -> TGAGCGGGCCT
CGTTCTAGCGG -> GTTCTAGCGGA
AAAGTGTGGTA -> AAGTGTGGTAA
ACTCGGAAGTT -> CTCGGAAGTTA
GTTATAAGAGT -> TTATAAGAGTG
CCTCGTATATA -> CTCGTATATAG
GAGCCCAGTTC -> AGCCCAGTTCT
AGTACCGTATT -> GTACCGTATTG
GCCGTTCTAGC -> CCGTTCTAGCG
GTTTGATGACC -> TTTGATGACCT
GCGGCTATATG -> CGGCTATATGA
GTCTTTTAGTT -> TCTTTTAGTTC
TTGTCCGATGA -> TGTCCGATGAG
CTTAGACTGGG -> TTAGACTGGGA
CGTCGATTGCA -> GTCGATTGCAC
CCCCGTTGCCA -> CCCGTTGCCAT
CTGGGTCTAGT -> TGGGTCTAGTT
ACCCCCGGACT -> CCCCCGGACTC
GCCGGAGTTCT -> CCGGAGTTCTT
CGTCATGAGGG -> GTCATGAGGGT
CGGGACAAGAA -> GGGACAAGAAT
GGTTAGGCTGA -> GTTAGGCTGAT
GCGTCTCGATC -> CGTCTCGATCA
TATTGGTACCG -> ATTGGTACCGC
TCTCTCGGCAG -> CTCTCGGCAGG
AGAGGATGCCA -> GAGGATGCCAG
CGATCCACCTC -> GATCCACCTCA
CAGAAGTAGTC -> AGAAGTAGTCC
CCGCGCCTTTC -> CGCGCCTTTCT
GACTAGGATCG -> ACTAGGATCGC
TGTGATTGTCG -> GTGATTGTCGC
CGGCTATTAGA -> GGCTATTAGAG
CTTACAGGCCA -> TTACAGGCCAG
AAGGAGCCGCC -> AGGAGCCGCCT
ACAATCCCAAA -> CAATCCCAAAC
CTTGTAGATTA -> TTGTAGATTAC
GTTTCACTCTA -> TTTCACTCTAA
GTCCGCCCCAG -> TCCGCCCCAGA
CTTTCTGCTTG -> TTTCTGCTTGA
GTAGATTACCA -> TAGATTACCAT
CAGTGCCTTTA -> AGTGCCTTTAT
AAATCCTTTTA -> AATCCTTTTAT
GTACAGTTTTT -> TACAGTTTTTC
GGCCTCCTGTG -> GCCTCCTGTGC
GAGGGCGGATA -> AGGGCGGATAA
AAGCAAGGCTC -> AGCAAGGCTCA
GATCGGCTCGA -> ATCGGCTCGAT
CGGCTATATGA -> GGCTATATGAT
CCGTTCTAGCG -> CGTTCTAGCGG
ATCTCTAGATT -> TCTCTAGATTC
AGGGCGGATAA -> GGGCGGATAAC
ACTCATAGAAT -> CTCATAGAATG
TAATGAGTAAA -> AATGAGTAAAT
AGTGCTTCTTG -> GTGCTTCTTGA
CATAGCTGCCC -> ATAGCTGCCCT
TCGGTGTATAC -> CGGTGTATACG
GCGGGAGTCAT -> CGGGAGTCATA
TATAGATCGGT -> ATAGATCGGTG
TAGATCGGTGC -> AGATCGGTGCC
TGTTCTCTCGC -> GTTCTCTCGCT
CGAATCTAAGC -> GAATCTAAGCA
ATTCATGTTTC -> TTCATGTTTCG
AGCTGATGATT -> GCTGATGATTA
GGAAAGGTCGA -> GAAAGGTCGAG
TCCTTTGTCTC -> CCTTTGTCTCT
GTATATAGATC -> TATATAGATCG
TGAGGCAGCCG -> GAGGCAGCCGT
AGGTTGGCGCC -> GGTTGGCGCCG
TGGAGGCATAA -> GGAGGCATAAG
CTTTTAGTTCA -> TTTTAGTTCAC
ATTAGCTGGTA -> TTAGCTGGTAT
AGTTACCTAGC -> GTTACCTAGCG
GTCCAGAAACG -> TCCAGAAACGG
ACAGTGCCTTT -> CAGTGCCTTTA
TCGCTCCCACG -> CGCTCCCACGA
GCACTGACCGA -> CACTGACCGAG
CTCACCGATTT -> TCACCGATTTG
TATGGTTAGGC -> ATGGTTAGGCT
GATGCCAGGAG -> ATGCCAGGAGC
TACAGTTTTTC -> ACAGTTTTTCG
TCTGTTTGATG -> CTGTTTGATGA
GCCCAATATTA -> CCCAATATTAG
CGGTAGTAGAC -> GGTAGTAGACC
GCCTCCTGTGC -> CCTCCTGTGCA
TAGAGCCTGTC -> AGAGCCTGTCA
GTGACTGATAC -> TGACTGATACG
CGGATAGCATA -> GGATAGCATAT
GCTTGAGCTAG -> CTTGAGCTAGA
GGGCCCAATAT -> GGCCCAATATT
TGGTATGCTGG -> GGTATGCTGGT
ACACGATATCC -> CACGATATCCG
AAAGCTGTGCC -> AAGCTGTGCCC
GGCATAAGCGG -> GCATAAGCGGC
TGTCATATTAA -> GTCATATTAAC
TAAGGAGCCGC -> AAGGAGCCGCC
GACGTCATATA -> ACGTCATATAT
CAGAAAGCGAG -> AGAAAGCGAGC
AGTGTGGTAAT -> GTGTGGTAATG
GTATACGCCGA -> TATACGCCGAG
CGGTGCTTTGT -> GGTGCTTTGTT
AGAGTGTTAGG -> GAGTGTTAGGC
CGTATTGAGAT -> GTATTGAGATA
CGCGAGAGTTG -> GCGAGAGTTGA
CTGCAAAATTC -> TGCAAAATTCG
AGATACAACGT -> GATACAACGTC
GTGATGGTCCA -> TGATGGTCCAG
CCGAAGATCAC -> CGAAGATCACC
GACTGGGAAAG -> ACTGGGAAAGG
AACCGCTGTAC -> ACCGCTGTACA
CTTCAGCTAAT -> TTCAGCTAATT
TGAGACCTCAC -> GAGACCTCACC
ACCGTATTGAG -> CCGTATTGAGA
CTCATAGAATG -> TCATAGAATGC
CCTTTCTCCTG -> CTTTCTCCTGC
ATCACTTGCAC -> TCACTTGCACT
AAGGTCGAGAA -> AGGTCGAGAAC
GGTTGCCATAA -> GTTGCCATAAA
GTCGCTCTCTC -> TCGCTCTCTCT
GATTACGATCG -> ATTACGATCGG
TGCAGGGAAAA -> GCAGGGAAAAG
GATCCAAGCAT -> ATCCAAGCATA
AGTAGTCCTAA -> GTAGTCCTAAG
ATCCGCGCCTT -> TCCGCGCCTTT
TTTGATGACCT -> TTGATGACCTC
CACTTGTAGAT -> ACTTGTAGATT
CAGCTAATTAC -> AGCTAATTACT
AACACTGCAAG -> ACACTGCAAGC
CGTGGTATCTC -> GTGGTATCTCT
ATTAGCACAAT -> TTAGCACAATC
CCCCCGGACTC -> CCCCGGACTCA
GGGACAATCCC -> GGACAATCCCA
GATCCAACACA -> ATCCAACACAA
CGAGAGAAAGG -> GAGAGAAAGGC
TGGTACCGCTC -> GGTACCGCTCT
TTAGAGCCTGT -> TAGAGCCTGTC
AGAGGAACTAA -> GAGGAACTAAC
ATAGCTGCCCT -> TAGCTGCCCTG
GTACACGATAT -> TACACGATATC
GTACCGTACGA -> TACCGTACGAA
CAGGCCAGGCG -> AGGCCAGGCGA
GAATGCGTACC -> AATGCGTACCG
ACCTCGTATAT -> CCTCGTATATA
AGCGGCGACTA -> GCGGCGACTAA
CCACTTGTAGA -> CACTTGTAGAT
CAATAGCGTCT -> AATAGCGTCTG
TATGGTGCCTC -> ATGGTGCCTCG
ATGAGGCAGCC -> TGAGGCAGCCG
CAGAGGATGCC -> AGAGGATGCCA
GCTAGACGAAG -> CTAGACGAAGC
TGATGAGACCT -> GATGAGACCTC
AGGCTCGCTCT -> GGCTCGCTCTA
ACTAACGACGC -> CTAACGACGCT
AGTGCCTTTAT -> GTGCCTTTATC
TATTCTCTTCA -> ATTCTCTTCAC
GTCTTGTATGG -> TCTTGTATGGT
CTTGTGCAGGG -> TTGTGCAGGGA
TCCGATGAGGC -> CCGATGAGGCA
GTGCGCAAGGG -> TGCGCAAGGGT
CGCGGTTGACT -> GCGGTTGACTA
ACCGTGCGCGA -> CCGTGCGCGAG
CTCTCGCTTGT -> TCTCGCTTGTG
GCGGATAACGT -> CGGATAACGTT
CAAGGCTCACA -> AAGGCTCACAC
ATCACGCCCTA -> TCACGCCCTAA
GCTGCCCTGAG -> CTGCCCTGAGT
CTACGCTTCCT -> TACGCTTCCTT
GCATGTTCGTC -> CATGTTCGTCC
ACGAACACTGC -> CGAACACTGCA
GTGCAGGGAAA -> TGCAGGGAAAA
ACTGAGTGCTT -> CTGAGTGCTTC
TTCGCGGTTGA -> TCGCGGTTGAC
GCAAAATTCGA -> CAAAATTCGAC
GAAACGGTCGT -> AAACGGTCGTC
TATTAGAGAGC -> ATTAGAGAGCG
TGAGCTAGACG -> GAGCTAGACGA
CAAATTGTCTT -> AAATTGTCTTG
CTAAAAGAAAG -> TAAAAGAAAGT
GCATACGGCCC -> CATACGGCCCT
AGAACACTGCA -> GAACACTGCAA
TCCGGATAGCA -> CCGGATAGCAT
AGTTATAAGAG -> GTTATAAGAGT
CCACGCTCGGT -> CACGCTCGGTT
GAACACTGCAA -> AACACTGCAAG,AACACTGCAAA
TGGTACAGTTT -> GGTACAGTTTT
CTCCTGTGCAA -> TCCTGTGCAAA
CATAACAGTGC -> ATAACAGTGCC
CAATCCAAGCT -> AATCCAAGCTA
GCGCCGTTCTA -> CGCCGTTCTAG
ATCCTAAAAGA -> TCCTAAAAGAA
CACGCATTTGT -> ACGCATTTGTA
GATCGGTGCCT -> ATCGGTGCCTC
CATACGGCCCT -> ATACGGCCCTT
TATTCATGTTT -> ATTCATGTTTC
CGGGGTAGCAT -> GGGGTAGCATA
CTGCTCGCTCC -> TGCTCGCTCCC
CCTTTCTGCTT -> CTTTCTGCTTG
ACGAACCGAAG -> CGAACCGAAGA
CGAACCGAAGA -> GAACCGAAGAT
ATCATCTAGTC -> TCATCTAGTCG
AGCATTCGTTT -> GCATTCGTTTT
CGGAGTTCTTG -> GGAGTTCTTGG
TTCACTGACGC -> TCACTGACGCG
CTGTCATATTA -> TGTCATATTAA
CGATGACCGGC -> GATGACCGGCA
CGCTTTAGCGT -> GCTTTAGCGTG
CTGAAGCTGAT -> TGAAGCTGATG
GTTGTTATAAG -> TTGTTATAAGA
GTAGACCTCGG -> TAGACCTCGGT
GCTCGCCTCTC -> CTCGCCTCTCA
TCTTGTACACG -> CTTGTACACGA
TGGGAGAGGAA -> GGGAGAGGAAC
GGAGTCATAAT -> GAGTCATAATA
GTCATATATTG -> TCATATATTGT
ATACGGCCCTT -> TACGGCCCTTT
GCTTACAGGCC -> CTTACAGGCCA
AATTCGACAGC -> ATTCGACAGCC
CTAAGGTAGAC -> TAAGGTAGACA
AATGAACGTAA -> ATGAACGTAAC
CCTTGCGGGGT -> CTTGCGGGGTA
AGGAACTAACG -> GGAACTAACGA
GGAAAAGCTGT -> GAAAAGCTGTG
CCCTAGCGTCA -> CCTAGCGTCAG
GTCATCCTAAA -> TCATCCTAAAA
AGCATATCCGC -> GCATATCCGCG
CCTCCTGCTCG -> CTCCTGCTCGC
ATACTTAAATC -> TACTTAAATCA
TACATGCCCAG -> ACATGCCCAGA
GCTCTTCTGTT -> CTCTTCTGTTT
CCCACGCTCGG -> CCACGCTCGGT
CAGCCACGGGT -> AGCCACGGGTC
CCGGACTGAGT -> CGGACTGAGTG
TTTTCCCTCCA -> TTTCCCTCCAG
TAGGGCCTCCT -> AGGGCCTCCTG
TGCTCGCTCCC -> GCTCGCTCCCA
CATAGAATGCC -> ATAGAATGCCA
ATCCTTTTATT -> TCCTTTTATTC
ATCAATAGCGT -> TCAATAGCGTC
TGCGATCCACC -> GCGATCCACCT
TTTTCGCGGTT -> TTTCGCGGTTG
GTCGTGAGGTG -> TCGTGAGGTGT
TGCCCAGGTTA -> GCCCAGGTTAT
GGTATGCTGGT -> GTATGCTGGTG
AGGCCAGGCGA -> GGCCAGGCGAC
GGAACTAACGA -> GAACTAACGAC
TTCGTTTTCCG -> TCGTTTTCCGT
CAATCAGATCC -> AATCAGATCCA
AGCATACATGC -> GCATACATGCC
CCTGTAATCAC -> CTGTAATCACG
GTACAGGCGAC -> TACAGGCGACA
CACGGAGCCCA -> ACGGAGCCCAG
CACACTTAGAC -> ACACTTAGACT
CCATTAGCACA -> CATTAGCACAA
GGTAATGAGTA -> GTAATGAGTAA
CGCCACTCTGG -> GCCACTCTGGA
CGGCACTATGC -> GGCACTATGCT
CCTAACCCCCG -> CTAACCCCCGG
CGGTGTATACG -> GGTGTATACGG
ATATGATGAGA -> TATGATGAGAC
AAATGAACGTA -> AATGAACGTAA
CTCACCCACGC -> TCACCCACGCT
CTAGCGGAGTT -> TAGCGGAGTTA
GTGATGATGGA -> TGATGATGGAG
TCGCACACATT -> CGCACACATTA
TCTGGACGGGA -> CTGGACGGGAC
GTGCCTTTATC -> TGCCTTTATCA
GAGACCAGTGA -> AGACCAGTGAA
TAAAGATACCT -> AAAGATACCTG
TGTTTCACTCT -> GTTTCACTCTA
GCGCGAGAGTT -> CGCGAGAGTTG
ACGCTAAGCAT -> CGCTAAGCATT
CGGTGTGATTG -> GGTGTGATTGT
CGCTCTTCTGT -> GCTCTTCTGTT
CACGATATCCG -> ACGATATCCGC
CAGCATACATG -> AGCATACATGC
TGGTCCAGAAG -> GGTCCAGAAGT
CGACGCTAAGC -> GACGCTAAGCA
GAGGTTGGCGC -> AGGTTGGCGCC
TGAATGCGTAC -> GAATGCGTACC
CGACTAAAGAT -> GACTAAAGATA
ACAGAAAGCGA -> CAGAAAGCGAG
TCTAAAATTGA -> CTAAAATTGAG
TAAAATCCTTT -> AAAATCCTTTT
ACTGCAAAATT -> CTGCAAAATTC
AGACTGGGAAA -> GACTGGGAAAG
TCCAGTTGGAG -> CCAGTTGGAGG
GCTCTAAAATT -> CTCTAAAATTG
CCGCTCTTCTG -> CGCTCTTCTGT
TTTACAACCAT -> TTACAACCATA
ACCATAGCTGC -> CCATAGCTGCC
GCCCTGAGTTA -> CCCTGAGTTAT
CGTTCAATCCA -> GTTCAATCCAA
GGGAAAGGTCG -> GGAAAGGTCGA
TACCGTACGAA -> ACCGTACGAAC
AATCCAGTTGG -> ATCCAGTTGGA
GCATATCCGCG -> CATATCCGCGC
CGAGCGCACAG -> GAGCGCACAGA
GACTGATACGT -> ACTGATACGTA
TGCCCAGAAAC -> GCCCAGAAACA
ACAAGAATCCA -> CAAGAATCCAG
GACTCACCTCG -> ACTCACCTCGT
CTAACCCCCGG -> TAACCCCCGGA
TTGAGTACCGT -> TGAGTACCGTA
TCGTATATAGA -> CGTATATAGAT
ATTCACTGACG -> TTCACTGACGC
AGAGCGCTTAC -> GAGCGCTTACA
TCAGTACTCAC -> CAGTACTCACA
AGCGTGGTATC -> GCGTGGTATCT
TACGATCGGCT -> ACGATCGGCTC
ACAACCATAGC -> CAACCATAGCT
GCCGGTACAGG -> CCGGTACAGGC
CGGTCGTCGTG -> GGTCGTCGTGA
GACCTCATAAG -> ACCTCATAAGG
CCCGGACTGAG -> CCGGACTGAGT
CCAGTTCTAAC -> CAGTTCTAACT
AGAATGCCACA -> GAATGCCACAG
CCACGCATTTG -> CACGCATTTGT
AGAGAAAGGCA -> GAGAAAGGCAT
CGCCCCAGAGG -> GCCCCAGAGGA
CTCACCTCTCC -> TCACCTCTCCA
TTGTCTCTTGT -> TGTCTCTTGTA
TATTAACGGCA -> ATTAACGGCAT
TTTATCAAGAG -> TTATCAAGAGA
GCTCACCCACG -> CTCACCCACGC
CCTACAATCCA -> CTACAATCCAA
TTACTATTGGT -> TACTATTGGTA
TTGGTGCCGGA -> TGGTGCCGGAG
GGCGACAGCAC -> GCGACAGCACC
TAAATGAACGT -> AAATGAACGTA
CGCTCTCTCTC -> GCTCTCTCTCG
GATGGAGTCCG -> ATGGAGTCCGC
CTCCACTCCAC -> TCCACTCCACG
CCGGATAGCAT -> CGGATAGCATA
AGCCTGTCATA -> GCCTGTCATAT
GATAGCATATC -> ATAGCATATCC
GGATGTTTCAC -> GATGTTTCACT
AACCACCCATG -> ACCACCCATGT
CGCTTCCTTTG -> GCTTCCTTTGT
CCCAATATTAG -> CCAATATTAGA
TTGCACTGACC -> TGCACTGACCG
AGATCCAACAC -> GATCCAACACA
GCGTGGGAGAG -> CGTGGGAGAGG
TACCGTATTGA -> ACCGTATTGAG
GATCGGGACGT -> ATCGGGACGTC
ACGCTTCCTTT -> CGCTTCCTTTG
CCGCTTTAGCG -> CGCTTTAGCGT
GGTGCCTCGGT -> GTGCCTCGGTA
GCTACGCCGCT -> CTACGCCGCTC
GTTACTGAAGC -> TTACTGAAGCT
CCCCGGACTCA -> CCCGGACTCAC
ACCGTACGAAC -> CCGTACGAACA
GGTGCTTTGTT -> GTGCTTTGTTG
TTAGGCTGATC -> TAGGCTGATCC
CATGCCCAGAA -> ATGCCCAGAAA
GATATCCGCGT -> ATATCCGCGTT
GACACAGTACT -> ACACAGTACTG
GCGAGAGTTGA -> CGAGAGTTGAG
ACAAGCGTCTC -> CAAGCGTCTCG
AGACCACTTGT -> GACCACTTGTA
GAGGGTACACT -> AGGGTACACTT
GACTGAGTGCT -> ACTGAGTGCTT
CGAGCGAGGTT -> GAGCGAGGTTG
GCAAGGGTGAT -> CAAGGGTGATC
ATGCCACAGCA -> TGCCACAGCAT
CTATTGGTACC -> TATTGGTACCG
AACACTGCAAA -> ACACTGCAAAA
CGCTCTATTCT -> GCTCTATTCTC
GCCGCCTACAA -> CCGCCTACAAT
GATCCACCTCA -> ATCCACCTCAA
TTTCTCCTGCT -> TTCTCCTGCTC
TCGGCTCGATC -> CGGCTCGATCG
TGACCTCATAA -> GACCTCATAAG
CAAGAATCCAG -> AAGAATCCAGT
CGGAGCCCAGT -> GGAGCCCAGTT
TGCTTGAGCTA -> GCTTGAGCTAG
CCTCGGTCCCC -> CTCGGTCCCCG
GTTGACTAGGT -> TTGACTAGGTT
GTAGTCCAACC -> TAGTCCAACCA
TCACTGACGCG -> CACTGACGCGC
CACTCTAAAGT -> ACTCTAAAGTG
TGGCCTTGCGG -> GGCCTTGCGGG
TGCGCTACTAC -> GCGCTACTACG
GTTTACAACCA -> TTTACAACCAT
TCGGTGCTTTG -> CGGTGCTTTGT
GCTACTACGCT -> CTACTACGCTT
CTCGCTCCCAC -> TCGCTCCCACG
AAGGCATTCAC -> AGGCATTCACT
CTCTCGGCAGG -> TCTCGGCAGGG
CCCCCGTTGCC -> CCCCGTTGCCA
AATCCAAGCTA -> ATCCAAGCTAT
ACACTGCAAAA -> CACTGCAAAAT
TGATCGGGACG -> GATCGGGACGT
AGTGAATGCGT -> GTGAATGCGTA
GGTGCCTCCCG -> GTGCCTCCCGG
CCTGCTCGCTC -> CTGCTCGCTCC
TTCGGTGCTTT -> TCGGTGCTTTG
GGTTGACTAGG -> GTTGACTAGGT
GGTCAGGCGCG -> GTCAGGCGCGT
TTTAGTTCACT -> TTAGTTCACTC
TTGAGATACAA -> TGAGATACAAC
CCTAGCGTAAA -> CTAGCGTAAAA
CGATCACTTGC -> GATCACTTGCA
AAAGGCATTCA -> AAGGCATTCAC
GAGCGGGAGTC -> AGCGGGAGTCA
AAACGGTCGTC -> AACGGTCGTCG
CGGATAACGTT -> GGATAACGTTC
GGACAAGAATC -> GACAAGAATCC
AGTCCTAAGGT -> GTCCTAAGGTA
GACGAAGCCGG -> ACGAAGCCGGT
GCGCTACTACG -> CGCTACTACGC
CTCGATGACCG -> TCGATGACCGG
TGAGATACAAC -> GAGATACAACG
GGCCCTTTCTC -> GCCCTTTCTCC
CACGGGTCAGG -> ACGGGTCAGGC
TGTCGCTCTCT -> GTCGCTCTCTC
CGCTTACAGGC -> GCTTACAGGCC
CTGCTTGAGCT -> TGCTTGAGCTA
CGACAGCACCG -> GACAGCACCGT
TGAGTACCGTA -> GAGTACCGTAT
GCTCTCTCTCG -> CTCTCTCTCGG
TCATAATACTT -> CATAATACTTA
TCTCTGTCCAG -> CTCTGTCCAGA
CCAGAAACGGT -> CAGAAACGGTC
GCTCTATTCTC -> CTCTATTCTCT
CCAGTTGGAGG -> CAGTTGGAGGG
GAACTAACGAC -> AACTAACGACG
CGTCTCGATCA -> GTCTCGATCAC
CCCTGAGTTAT -> CCTGAGTTATA
CAGCACCGTCA -> AGCACCGTCAT
ATATCCGCGTT -> TATCCGCGTTT
GCGACAGCACC -> CGACAGCACCG
GAGCGAGGTTG -> AGCGAGGTTGG
CTAGTTGTAGT -> TAGTTGTAGTA
TAACGTTCAAT -> AACGTTCAATC
CAATCCAATCC -> AATCCAATCCG
TAAAAGAAAGT -> AAAAGAAAGTC
GTACGGGCGTG -> TACGGGCGTGG
AGAGACCAGTG -> GAGACCAGTGA
ATCCGCGTTTA -> TCCGCGTTTAC
TAGCGTCAGTA -> AGCGTCAGTAC
CAACACAAATG -> AACACAAATGA
GAGAGCGGGAG -> AGAGCGGGAGT
TTCTTCGTAGA -> TCTTCGTAGAC
GCGACTAAAGA -> CGACTAAAGAT
ACATTAGGGCC -> CATTAGGGCCT
AGCGTCTCGAT -> GCGTCTCGATC
CTACTACGCTT -> TACTACGCTTC
CACCGTCATGA -> ACCGTCATGAT
CGCCGTTCTAG -> GCCGTTCTAGC
ACGTACGGGCG -> CGTACGGGCGT
AAATGATCGGG -> AATGATCGGGA
TGGTGACTGAT -> GGTGACTGATA
AGCAGTGGTGC -> GCAGTGGTGCG
ACGCCGAGCGC -> CGCCGAGCGCA
CGAACACTGCA -> GAACACTGCAA
TAGACCTCGGT -> AGACCTCGGTC
GGGCCCACGCA -> GGCCCACGCAT
CTCACAGCCTG -> TCACAGCCTGT
TCACTCTAAAG -> CACTCTAAAGT
GCCTGTAATCA -> CCTGTAATCAC
TCTTGGAGGCA -> CTTGGAGGCAT
AAGATCACCTC -> AGATCACCTCG
TGTGCAAATTG -> GTGCAAATTGT
TTCTGTTTGAT -> TCTGTTTGATG
ACGTCATATAT -> CGTCATATATT
AAGGCTCACAC -> AGGCTCACACT
CGACAGCCACG -> GACAGCCACGG
CATGTTTCGGT -> ATGTTTCGGTG
GCTCGCTCCCA -> CTCGCTCCCAC
GTGTTAGGCTC -> TGTTAGGCTCG
CATACATGCCC -> ATACATGCCCA
ATTGCACATAA -> TTGCACATAAC
TTGGTTGCCAT -> TGGTTGCCATA
TTGTAGTACTT -> TGTAGTACTTG
AGCATACGGCC -> GCATACGGCCC
CGTACGGGCGT -> GTACGGGCGTG
TTTCTGCTTGA -> TTCTGCTTGAG
CTGTGCAAATT -> TGTGCAAATTG
CGAAGATCACC -> GAAGATCACCT
ATGGAGTCCGC -> TGGAGTCCGCC
CGGGCCTTGTA -> GGGCCTTGTAC
CCGATGAGGCA -> CGATGAGGCAG
ACACTTAGACT -> CACTTAGACTG
TCGATCACTTG -> CGATCACTTGC
AGTTGAGTACC -> GTTGAGTACCG
AACGTAACCTT -> ACGTAACCTTG
GCCACGGGTCA -> CCACGGGTCAG
CTCTGTCCAGA -> TCTGTCCAGAA
GTTTCGGTGTA -> TTTCGGTGTAT
TACGAACACTG -> ACGAACACTGC
TGCCCTAGCGT -> GCCCTAGCGTC